anterior	前面的			
shirk	逃避			
hegemony	霸权			
release	排放；释放；解雇			
sloppy	邋遢不整洁的；混乱的			
gourmet	美食家			
doyen	资深人士；高级会员			
epilogue	文学作品的结局；戏剧收场白			
mawkish	a 过度伤感的			
contumacious	不服从的			
solace	安慰安抚			
blackmail	敲诈勒索			
fatuous	愚笨的			
falsehood	谎言			
waylay	伏击；埋伏			
amenable	顺从的			
subservient	奉承的；屈从的			
disprove	反驳 证明为假			
talisman	护身符			
glut	过量			
inevitable	不可避免的			
flag	旗帜；变得衰弱			
compliant	顺从的			
languish	变得虚弱			
prate	闲聊			
constrain	限制；使人屈服于			
careen	蹒跚而行；狂奔 快速运动			
legion	大量的			
relish	偏爱；满足感；享受			
gauche	笨拙的			
corporeal	肉体的；有形的			
paltry	无价值的微不足道的；让人厌恶鄙视的			
measured	a 深思熟虑的			
enamored	迷恋的			
obdurate	固执的；冷酷无情的			
acrimonious	刻薄的			
demolition	破坏			
racy	活泼生动的			
secede	脱离、退出			
perceptive	敏锐的；洞察力强的			
momentum	动力；势头			
overlap	部分重叠			
abject	无精打采的；悲惨的；讨好的			
repress	镇压；阻止			
foible	小缺点			
stingy	吝啬的；极少量的			
palliate	减轻，平息			
affirm	声称肯定……为真			
scrawl	乱涂 潦草地写			
repulse	厌恶 排斥			
decadence	衰落			
repatriate	遣返			
deject	使沮丧			
stouthearted	大胆的			
sequester	使隔绝；使隐退			
aberrant	异常的			
culpable	有罪的			
connive	共谋；纵容			
ludicrous	荒唐可笑的			
vestige	微小的遗迹；小痕迹			
curriculum	课程表			
immure	监禁			
turbulent	汹涌的；动荡的			
evoke	唤起			
withhold	扣压、抑制			
dexterous	灵巧的；头脑灵活的			
fury	暴怒			
clandestine	隐藏的			
mulish	固执的			
splice	接合			
fortify	增强；做好心理准备			
swear	咒骂；宣誓			
aggrieve	使苦恼			
nuance	细微的差异			
tinge	给�着上少量的色彩			
paraphrase	意译，转述，改写			
inchoate	未完全成形的；新生的才开始的			
reconcile	使和谐			
placate	平息抚慰			
condole	表达同情或悲伤			
diehard	顽固分子；顽固的			
frenzy	疯狂			
humor	幽默；迎合			
inure	使习惯接受不好的东西；使坚强			
rapscallion	流氓			
dated	过时的			
resurgence	复兴			
distinctive	完全不同的；典型的			
minute	仔细的；小的不重要的			
turmoil	骚动 ，混乱			
adore	酷爱；宠爱			
responsive	反应快的			
shred	少量			
parity	相称，同等，平等			
dawdle	闲荡			
cloudburst	暴雨			
counterpart	对等的人或物			
idolatrize	盲目崇拜			
aver	声称为真；声明			
peripheral	外围的；辅助性的			
dandy	纨绔子弟；最好的			
stupor	迟钝；无知觉			
deprecate	不赞成不喜欢；贬低；使低调			
blemish	缺点；玷污			
roisterer	喝酒喧闹的人			
dissipate	驱散；浪费；放纵			
disinfect	消毒使无菌			
skeleton	骨架			
gadfly	刺激物；令人讨厌的人			
abstain	自我克制			
voluminous	卷数多的；大量的			
fatigue	疲惫；苦差事			
jocular	搞笑的			
allegiance	忠诚			
exalt	提升提拔；赞扬			
surrender	交出放弃；使沉溺于			
dissension	意见不合			
damn	谴责；非常地			
retinue	随行人员			
detach	分离			
prosecution	实行，执行			
amity	友好关系			
divestiture	剥夺			
novice	新手 			
rehabilitate	使复原康复；使洗心革面			
debacle	溃败			
lull	n 间隙的平静；vt 使安心			
maculate	vt 玷污；损坏			
run	连续演出			
understate	保守陈述			
obliterate	除去			
knit	编织；连接联系			
guilt	罪行；自责悔恨			
ungainly	笨拙的			
yoke	连接			
balky	倔强的，不服管束的			
fusty	过时的；恶臭的			
archaic	过时的			
scrupulous	正直的；一丝不苟的			
provoke	激怒；驱使			
annals	年鉴			
wither	枯萎			
garrulous	_嗦的			
viscous	粘稠的 粘的			
prerogative	特权			
luminary	n 杰出人物			
diocesan	主教管辖区的			
cement	连接粘合			
denouement	（小说的）结局			
caprice	一时冲动的决定；反复无常			
wanting	缺少的；未达到要求的			
infiltrate	秘密潜入			
designate	任命；命名			
ration	定量配给；按比例分配			
neophyte	新手			
persecute	迫害			
opaque	不透光的；晦涩的			
suppress	抑制；镇压 终止			
supine	懒散的；消极倦怠的			
perceptible	可察觉的			
imbroglio	纠纷；困境			
entice	诱使			
overwhelm	淹没；使难以承受			
sepulchral	丧葬的；阴沉的			
bootless	无用的			
embrace	乐于接受；包围			
gargantuan	巨大的			
attune	使协调			
analgesic	镇痛剂			
proficient	熟练的			
jape	嘲弄			
rile	惹怒			
concatenate	连结			
execrate	谴责			
vestigial	发育不全的、退化的			
plush	味道浓郁的；奢华的			
rumple	弄皱；弄乱			
boisterous	喧闹的			
precursor	先驱			
analogous	相似的，可比较的			
downpour	倾盆大雨			
clement	仁慈的；气候温和的			
sparse	稀疏的			
spiny	多刺的；棘手的麻烦的			
wiretap	偷听			
disjointed	机能失调的；散乱的不连贯的			
facilitate	使容易；促进			
counterproductive	相反效果的，事与愿违的			
cramped	狭窄的			
grieve	使痛苦；严重的；令人悲痛的			
hallucination	幻觉			
redundant	多余的			
ascendant	主宰的、有影响力的；上升的			
ethereal	轻巧精致的；天国的；精神上的			
advertise	做广告			
mirage	幻影海市蜃楼			
slant	角度看法；倾斜的；歪曲			
lenient	宽大仁慈的			
dehydrate	脱水；使失去活力			
eclectic	多元化的			
needy	贫困的			
molt	脱羽、皮			
exude	分泌流出			
recessive	隐性的；内向的			
intensify	加强			
judicious	明智的			
aspersion	诽谤			
probe	深入调查			
comely	漂亮的			
acute	敏锐的；急性的；程度深的			
myriad	无限的大量的			
imperative	命令的；迫切的；必要的			
staunch	忠诚的，坚定的			
estrange	使疏远			
maven	n 专家			
bigot	固执己见者			
embark	上船；开始从事			
emaciate	使变瘦；使虚弱；削弱			
therapeutic	治疗的			
tact	机敏；圆滑			
repartee	机灵的回答；打趣，善意的玩笑			
jocund	欢乐的			
aesthetics	美学			
constitute	任命；构成			
ripen	使成熟			
retouch	润饰，改进			
trite	陈腐的			
drudgery	苦工；单调无趣的工作			
gladiator	角斗士；参与打斗或辩论的人			
inflame	使加剧；点燃助燃			
bewitching	迷人的			
shrink	减少；退缩；犹豫			
engross	使全神贯注			
repertoire	全部剧目；详单			
commitment	致力；确信；承诺			
playful	爱开玩笑、打闹的			
taxing	繁重的；费力的			
denude	脱去			
overbearing	专横傲慢的；压倒一切的；支配的			
simpleton	笨蛋			
wary	小心的；机警的			
substitute	替代品；取代			
heckle	起哄，使难堪			
dilate	使膨胀；详细表述			
agonize	折磨；感到痛苦			
conciliate	安抚；调解			
sham	欺骗；虚假的；掩饰假装			
condone	宽恕			
studio	工作室；画室；摄影室			
miserly	吝啬的			
sweltering	酷热的			
disengage	分开			
forsake	彻底放弃			
commensurate	同样大小的；相称的			
impassive	冷漠的			
nettle	惹怒			
mangle	vt 损毁；弄砸			
murky	模糊的；晦涩的			
jaunty	轻快的			
pillar	柱子；精神、物质支柱			
confident	自信的			
fetid	恶臭的			
revive	恢复意识；再获新生			
unanimous	一致同意的			
reprobate	堕落者；堕落的；谴责；拒绝			
spectrum	光谱；范围，系列			
indoctrinate	教育			
singe	轻微烧焦			
solicitous	关心挂念的；迫切渴望的			
chauvinistic	盲目爱国的			
caustic	腐蚀的；刻薄的			
deft	灵巧的			
alloy	合金 混合物；掺杂			
husky	沙哑粗糙；高大威猛			
eclipse	使声望下降使黯然失色；下降衰退；超越			
polished	有教养的；擦亮的			
array	排列；摆放；装饰			
satirize	讽刺			
adumbrate	部分揭露；预示着			
grisly	令人反感的			
deliberate	深思熟虑的			
trickle	一滴滴地流			
cachet	同意；声望			
rapprochement	和睦 友好			
forebode	预兆			
murmur	小声说话；低声抱怨			
shrewd	精明的；强烈的			
unpretentious	低调的；坦诚的自然的			
waylay	伏击；埋伏			
outmoded	过时的 			
wrangle	纷争争端；争吵			
sturdy	强健的			
buoyant	有浮力的；快乐的			
lacerate	使非常痛苦			
immaculate	纯净的；完美的			
deprivation	匮乏			
profusion	丰富；挥霍			
maverick	n 特立独行的人；a 非常规的，标新立异的			
balk	阻碍；拒绝			
ballad	由简单诗节和叠句组成的民歌			
