abandon	放纵；放弃；停止做某事			
paradox	似非而可能是的话，悖论			
coax	诱骗			
hodgepodge	大杂烩			
mash	vt 捣碎			
embezzle	盗用			
authentic	真实的			
swill	痛饮，大口地吃			
svelte	苗条的优雅的			
luxurious	a 豪华的；奢侈的			
abet	帮助；鼓励			
hidebound	极度保守的			
inalienable	不可剥夺的			
rail	猛烈抨击			
batch	一批次的量；一小群人			
perish	消亡			
jaded	疲惫的；厌倦的			
chaperone	同行护送			
monarch	君主；巨头 大亨			
versatile	多才多艺的全能的；易改变的			
fanatic	狂热的；狂热者			
resourceful	有创造力的；机智的			
diffuse	_嗦的；扩散的；散开			
feisty	好斗的 好争论的			
boor	粗鲁的人			
exuberant	非常高兴的；生机勃勃的；大量的			
gullible	易受骗的			
rigmarole	混乱而无意义的话			
evict	驱逐			
repel	抵制；使厌恶			
retainer	家仆			
impervious	不能被破坏的；不可渗透的；不为所动的			
effluvium	没用的副产品；难闻的气味			
accidental	意外的；不重要的			
flinch	畏缩			
stunt	阻碍成长			
sophism	诡辩			
peck	大量；小口咬			
glaze	上釉彩;使平滑			
moth-eaten	过时的			
fraught	充满的；令人忧虑的			
implement	实施；工具			
tether	栓；系；束缚；能力忍耐力的极限			
fabulous	传说中的；幻想中的；令人惊叹的；极好的			
blurt	突然说出			
mime	v. 模仿			
animus	敌意的			
harmonious	协调一致的			
atone	赎罪			
arid	干燥的；无趣的			
relinquish	放弃；交出移交			
vocation	职业			
strike	铸造；击打；攻击			
rapt	全神贯注的；狂热的			
effusive	感情奔放的			
reassure	使安心			
bland	乏味的；无趣的；温和的			
corroborate	用证据或权威证实；支持			
surpass	超过；突破			
soothe	安慰；使安心；缓解			
hasten	促进			
carve	雕刻；开创开拓			
consensus	一致同意			
dominant	显性的			
exotic	外来的不同寻常的			
proffer	献出			
fretful	苦恼的			
mastery	n 精通			
regimen	政治上的统治			
fable	寓言故事；神话传说；谎言虚构			
thorny	多刺的；棘手的麻烦的			
cavil	挑剔吹毛求疵			
conducive	有益的；促进的			
sunder	分裂			
doctrinaire	教条主义的			
prude	过分守礼的人，过分正经的人			
delve	探究			
condign	应得的			
fervid	热情的；酷热的			
remodel	改造，改变结构			
galvanize	刺激			
ephemeral	短暂的			
shiftless	无志气的；懒惰的			
preservative	防腐剂			
impunity	免受处罚			
aspect	外表			
toady	马屁精			
convergent	汇聚的			
glacial	极冷的；冷漠的			
paunchy	大腹便便的			
procrastinate	拖延			
extenuate	减轻罪过			
connoisseur	鉴赏家；专家			
heretical	异端的			
bash	猛击；用力击打；抨击批评			
recant	撤回；放弃；公开承认（错误）			
convalesce	渐渐康复			
clasp	紧握			
latent	潜在的			
perspicacious	极敏锐的			
obsequious	谄媚的奴性的			
burnish	擦光			
prune	梅干；修剪			
vagary	不可预测的思想、行为			
impetuous	冲动的；猛烈的			
outgoing	友好的			
propagate	繁殖；传播			
hortative	鼓励的			
chronic	经常发生的;积习难改的			
appeal	申请；上诉			
dampen	稍稍弄湿；压抑			
valiant	勇敢的			
concise	简洁的			
anarchist	无政府主义者、反抗权威的			
brook	忍受；小溪			
turgid	浮夸的			
pen	监狱；关押监禁			
incriminate	归罪于			
exempt	使免除			
mellifluous	a （曲调）优美的			
bathetic	平凡的			
buttress	扶墙；提供支撑的证据			
shroud	隐蔽物；遮蔽			
tonic	滋补的；有益健康的			
telling	有效的；显著的			
compelling	极具说服力的；迫切的			
cessation	终止			
reconvene	重新集合			
certitude	确信无疑			
loathe	vt.厌恶			
justify	证明……合理性			
plodder	行走缓慢的人			
succor	救援			
sarcasm	讽刺			
languid	无精打采的			
convulsion	痉挛；骚乱			
misdemeanor	轻罪			
proscribe	禁止；排斥			
complacency	自满			
tortuous	拐弯抹角的			
blunder	过失；糟蹋；蹒跚			
symmetry	对称			
prospect	勘探；期待的事物			
irrigate	灌溉；冲洗			
abut	毗邻			
check	阻止；一致、同意			
deplorable	可鄙的 可耻的；悲惨的			
terror	极度恐惧			
lapse	小过失；结束			
illuminati	智者；精英			
meek	a 谦恭的；a 顺从的			
glisten	闪光			
vanquish	征服			
nibble	小口咬			
plentitude	丰富；大量			
fascinate	强烈吸引			
palter	欺骗			
jest	轻浮的态度 戏谑			
pedant	书呆子，墨守成规的人			
scant	不足的			
contradict	否认；与……相矛盾			
propriety	礼节；适当得体			
giddy	轻浮的;喜悦的			
incogitant	考虑不周的；不体谅的			
incessant	无间断的			
stamina	耐力			
congenial	友善的			
acquiesce	勉强同意			
tarnish	玷污			
debunk	揭露；证明为假			
shun	避开			
cadge	乞讨			
oblique	斜的			
bellwether	领导人			
moderate	缓和；适当的			
asymmetry	不对称，不平衡			
bribe	贿赂			
alphabetical	按字母顺序的			
ramshackle	摇摇欲坠的			
malinger	vi 装病以逃避工作			
insight	洞察力			
mumble	说话含糊			
eddy	逆流			
idle	闲置的；懒散的；懒散度日			
exhaust	耗尽；使筋疲力尽			
foster	促进；养育			
champion	支持			
syllabus	课程大纲；摘要			
obstreperous	难以驾驭的；吵闹的			
slur	含糊地发音；忽略；耻辱			
apt	非常合适的；有�倾向的；聪明的			
mournful	悲伤的			
stentorian	声音洪亮的			
subsidiary	次要的；起辅助作用的			
deleterious	有害的			
recumbent	躺着的			
patina	外表；氛围气场			
suffocate	使窒息			
ensemble	合唱、合奏曲			
palatial	宫殿般豪华的			
ductile	可塑的；易受影响的			
assent	同意			
obscure	含义模糊的；使模糊；平凡的			
metaphysical	a. 理论上的； a. 非尘世的			
affluent	富裕的			
consent	同意；赞同			
conspire	合谋			
dispassionate	客观公正的			
indigenous	本地的；与生俱来的			
moribund	即将结束的；即将过时的			
bustle	喧闹；奔忙			
providential	天意的；幸运的			
humiliate	使耻辱			
deposit	沉积矿藏；存钱			
gaffe	失态；明显的错误			
condescending	姿态高人一等的			
resonant	洪亮的			
bungle	办糟			
hypnotic	有助睡眠的；安眠药			
travail	辛苦劳动			
vacuous	愚蠢的			
amorphous	无固定形状的；不可归类的			
rustic	乡下人；乡村的；粗俗的			
twig	了解			
self-abasement	自卑			
abrogate	正式废除；无视……存在			
detract	贬低；使分心			
perfervid	非常热心的			
timid	胆小的			
entrap	诱骗			
antic	滑稽可笑的			
institute	建立；制定；机构			
shopworn	陈旧的			
concur	同意；同时发生；团结合作			
retort	机智地回答			
cronyism	对好友偏袒，任人唯亲			
tycoon	大亨，巨头			
philanthropic	博爱的，为他人着想的			
lampoon	讽刺			
brazen	厚颜无耻的；大胆自信地面对或从事			
pious	虔诚的；忠诚的			
dearth	供应不足			
withdraw	收回；撤退			
ravenous	贪吃的；贪婪的			
germane	有关的			
abscond	潜逃			
negation	否定			
valediction	告别；告别词			
zesty	刺激的开胃的			
drawl	慢吞吞地说			
poach	水煮			
absurd	不合理的			
condemn	谴责			
apropos	合适的；相关的			
permeable	可渗透的			
conflagration	大火；武装冲突 战争			
fumble	拙劣地做；失误			
vouch	担保 声称为真			
misconstrue	误解			
tasty	美味的；令人愉悦的			
pine	渴望奢望；因渴望而憔悴			
plebeian	平民的			
rebuff	严厉拒绝			
methodical	a.有条理的			
bliss	极度快乐			
malleable	a 可塑的；易控制的			
supplement	增补			
fracas	吵闹			
badger	不断骚扰			
reiterate	重申			
precedent	先例；先前的			
defuse	减轻			
outset	开始			
improvise	即兴而作			
salutary	有益的			
deplore	哀悼；谴责			
translucent	半透明的；透明的			
tiff	小争吵			
peel	剥去……的皮；脱去衣服			
preface	序言			
banter	幽默的谈话			
qualify	限定；使有资格有能力			
outmaneuver	以策略制胜的			
apprehensive	理解的；害怕的			
homily	乏味的道德演讲			
balloon	迅速增加			
imposing	宏伟壮丽的			
oration	演说			
replete	吃饱了的；富于，充满			
ascetic	禁欲的；禁欲者			
rarefy	使稀薄			
mesmeric	a. 催眠的；a. 令人着迷的，难以抗拒的			
canard	谣传			
compound	混合物；复合的；混合			
relapse	故态复萌，再犯			
maladroit	a 笨拙的			
labyrinthine	迷宫似的，复杂曲折的			
anecdote	短小故事			
hardy	顽强的；愿意冒险的			
levelheaded	明智的			
sequela	结果			
stringent	绷紧的；严格的			
quash	镇压			
inexorable	无法劝阻的			
eminence	杰出			
squeamish	恶心的、晕船的			
concrete	实体的实在的；明确的事实性的			
goggle	凝视			
mercurial	a. （情绪）善变的			
retrench	削减开支			
pilfer	偷窃			
leer	一瞥			
equilibrium	平衡；平静			
don	穿上			
tenacious	顽固的不屈不挠的；黏着的			
discern	识别			
lustrous	a 有光泽的			
aggressive	好斗的；强有力的			
distort	扭曲			
concede	承认；停止抵抗			
avowal	承认 公开宣布			
reluctant	不情愿的			
pore	仔细研究			
committed	忠诚的			
courteous	谦恭有礼的			
sapient	聪明的			
metamorphose	vt. 使变形			
paradigm	典范			
ostensible	表面上的，佯装的			
insulate	使绝缘使隔离			
gild	修改润色			
fraudulent	欺诈的			
maneuver	巧妙地操纵			
vault	跳跃；一跃而至			
antediluvian	非常古老的；过时的；保守的人			
fathom	彻底理解；测量			
caveat	警告			
contrived	不自然的，刻意的			
skeptic	怀疑者			
provident	节俭的；有远见的			
endorse	公开支持			
vaporize	使蒸发；彻底消灭			
jejune	无趣沉闷的；幼稚的			
saccharine	有甜味的；做作的矫情的			
hasty	轻率的			
delegate	代表；移交			
notch	刻痕；通过努力获得			
implode	内爆			
sober	严肃的；节制的；有理有据的			
offish	冷淡的			
suture	缝合			
vaccinate	预防接种疫苗			
tinker	乱修乱调整			
nullification	废除			
recuperate	恢复；康复			
commiserate	表示怜悯同情			
accumulate	逐渐增长			
peer	同等地位的人；好奇地凝视			
transient	短暂的			
escort	护卫队；同行护送			
adamant	固执的			
minutiae	次要的细节、小事			
valid	逻辑上正确的			
incandescent	明亮灿烂的；热情饱满的			
circumvent	躲避绕行			
worldly	世俗的；老练的			
nicety	准确；细微差别			
ruminate	沉思			
foment	煽动			
retribution	报偿、报应 			
integrity	正直；完整			
viable	可行的			
circuitous	不直接的；冗长的			
kindle	点燃			
egalitarian	平等主义的			
havoc	大混乱；大面积破坏			
startle	使大吃一惊			
stultify	使无效			
snobbish	自大的			
chagrin	沮丧懊恼			
debilitate	使衰弱			
allure	引诱			
transcend	超越			
felony	重罪			
volition	意志、抉择			
expiate	赎罪纠正			
obloquy	谩骂；恶名耻辱			
bogus	伪造的；虚伪做作的			
drench	湿透			
incantation	咒语			
dulcet	悦耳的			
abash	使尴尬			
malaise	n 不舒服			
pungent	辛辣的，讽刺的			
haphazard	无秩序的			
sensitive	敏感的			
fallacious	荒谬的；欺骗性的			
elicit	唤起			
meteoric	a. 流星般迅速而短暂的			
amalgamate	合并			
timely	及时的；恰到好处的			
unremitting	连续不断的			
spate	突发的洪水；大量			
brake	刹车			
ill-bred	没礼貌的			
discretion	谨慎慎重；自制节制			
decipher	破译；理解			
religion	信仰；虔诚忠诚			
arrhythmic	不规律的			
crest	浪尖；山顶			
stint	吝惜			
parrot	机械地模仿、复制			
summit	顶点			
boon	恩惠；喜欢集体行动的			
torrid	酷热的；热情的，感情深厚的			
impotent	无力的；无生育能力的			
apostasy	放弃宗教信仰；变节			
mediocre	a 平庸的；质量中等偏下的			
mimic	a. 仿真的；vt. 模仿；vt. 滑稽地模仿（以取笑）			
catastrophe	大灾难			
lurch	vi 蹒跚			
quotidian	平凡的；每日的			
ethics	道德规范			
clot	密集的一群；堵塞；凝结			
deter	威慑			
full-bodied	味道浓烈的；重要的			
groggy	虚弱的 走路不稳的；头脑不清醒的			
renege	放弃			
fiasco	大失败			
reprieve	缓刑免罪；维持……运行			
elucidate	阐明			
acme	顶点			
circumspect	谨慎的			
spectator	观众			
accord	授予；相一致；一致			
laborious	勤奋的；费力的			
decode	解码；理解			
incursion	入侵			
sartorial	裁缝匠的			
pry	刺探			
gamble	赌博；冒险			
burgeon	迅速长大			
torpor	缺乏兴趣；迟钝懒散			
breach	破坏；违背			
gibe	嘲弄			
scorn	蔑视			
careworn	忧心忡忡的			
principal	主要的			
palpitation	有节奏的舒张收缩			
robust	精力充沛的；强壮健康的			
underdog	受害者，输家			
earshot	听力所及的范围			
ticklish	易怒的；棘手的对技巧要求高的			
psychology	心理学；心理战术			
meretricious	艳俗的			
porous	多孔可渗透的			
pellucid	透明的；清晰易懂的			
tacit	暗示			
persiflage	打趣			
esteem	尊重			
quaff	大口地喝			
collaborate	合作			
unavailing	徒劳的			
bromide	陈词滥调			
momentous	极重要的			
impenitent	不悔悟的			
licentious	a.放荡的，性欲强的			
enigma	迷			
specious	似是而非的，欺骗性的			
sumptuous	豪华的			
lurk	vi 潜伏			
embed	嵌入			
elbow	肘关节			
sinuous	蜿蜒曲折的			
dirge	挽歌			
rider	骑马的人；附加条款			
abstruse	难以理解的			
antiquated	古老过时的			
agenda	议程			
pernicious	有害的；致命的			
patrician	贵族；贵族的			
sulk	生气恼怒			
integral	构成整体所必需的			
plagiarize	剽窃			
amenity	舒适、人性化；和谐			
parch	烤干			
morose	忧郁的			
grimace	因痛苦而面部扭曲			
jeopardy	危险			
remiss	疏忽的			
enamel	涂亮漆；用亮丽的表面装饰			
relevant	有关系的；重要的			
resuscitate	使苏醒			
bluster	大声吹嘘；恐吓；喧闹的状态			
consummate	专业的有造诣的；完美的；最高档次的			
infuriate	激怒			
slew	大量			
confluence	汇合			
embolden	鼓励			
oblivious	不知道的不知情的；健忘的			
submissive	服从的；恭顺的			
paradise	天堂极乐世界；狂喜			
prerequisite	先决条件、前提			
complacent	自满的；无所谓不关心的			
heresy	异教			
gloomy	忧郁的；暗淡无光的			
pedagogical	教学的；教师的			
elephantine	巨大的，笨拙的			
harbinger	预言者			
husk	外壳；剥去			
ossify	僵化；骨化			
dreary	单调乏味的；令人不悦的			
solemnity	严肃			
invective	侮辱性的			
secrete	隐藏；分泌			
recidivate	重新犯罪，回到原来的习惯			
expire	断气死亡；到期			
coltish	不守纪律的；爱开玩笑的			
perforate	打孔			
trifle	不重要的事；玩弄			
hobble	蹒跚而行；阻碍			
fluster	使慌乱			
antipathy	反感厌恶；令人反感的事物			
friable	易碎的			
lax	松弛的 不严格的；漫不经心的			
mundane	尘世的；平凡的			
vague	表达不清楚的、轮廓不清晰的			
donor	捐赠人			
conceal	隐藏			
verve	活力热情			
largesse	慷慨；捐赠物			
reproach	责备；耻辱			
discompose	使不安使混乱			
practitioner	专业人士			
rabble	混乱的人群；暴民；下层民众			
malevolent	恶意的			
residual	剩余的			
habitable	可居住的			
preoccupation	非常关心			
affliction	痛苦折磨			
atrophy	萎缩衰退			
forebear	祖先			
emulate	效仿并努力超越			
skimp	吝啬；节省花费；缺乏的不足的			
plangent	轰鸣的；哀伤的			
sate	使满足			
pandemonium	"喧嚣,骚动"			
disabuse	打消错误念头，纠正			
ruse	诡计			
politic	精明能干的；明智的			
prodigal	败家子；挥霍的			
nadir	最低点			
solvent	有偿付能力的；溶剂			
barb	严厉的批评			
seduce	劝说			
rite	惯例、仪式			
berate	严厉指责			
throng	大量聚集			
jubilant	喜悦的			
mischievous	调皮的；有害的			
furor	喧闹;激动			
embarrass	使尴尬；阻碍			
callous	冷漠的；无情			
circumscribe	限制；包围			
finicky	过分讲究的			
simile	明喻			
half-baked	不明智的			
testimony	证据；声明			
fleeting	稍纵即逝的			
prophetic	预言的；预示的			
revenge	报复，复仇			
enunciate	清晰发言；公开宣布			
timeworn	陈腐的			
monotone	声音单调的；清一色的无聊的			
figurative	比喻的			
secular	世俗的			
inferno	大火；地狱			
reconstitute	重建，加水使复原			
rift	离间；使开裂			
chromatic	彩色的			
repudiate	否认；拒绝接受			
dilapidate	使荒废			
distain	贬损；弄脏			
slake	使满足			
squabble	小争吵			
mediate	vt 调解、调停			
applause	鼓掌；认可			
knack	诀窍			
cultivate	培养；促进成长			
deflect	使倾斜 使转向			
beneficent	仁慈的；有益的			
inherent	本质的			
subjugate	征服镇压；剥夺自由			
chaff	开玩笑			
understated	朴素的；不惹眼的			
demagogue	蛊惑民心的政客			
unkempt	凌乱的 无序的			
covert	隐藏的；隐秘掩护所			
fallible	可能出错的			
prototype	原型			
pout	撅嘴板着脸表示不悦			
garble	曲解篡改；筛选			
motile	能动的			
steep	浸泡；陡峭的；过高的			
barrage	弹幕；有压倒之势的倾泻			
florid	华丽的			
exceptional	特别的；非凡的			
ridicule	嘲笑			
minatory	a. 凶兆的			
homage	尊敬敬意			
perambulate	徒步穿越，走过			
collude	共谋、串通			
ostentatious	炫耀卖弄的			
stray	离群；迷途；漫无目的的			
reign	君主统治；占统治地位或盛行			
dais	主席台			
addendum	附录			
crass	粗俗的			
foliage	一簇叶子			
scourge	祸害			
dependable	可靠的			
convene	召集；集合			
stammer	口吃			
complementary	互补的			
argument	争吵；论证；观点			
quack	骗子医生			
escalate	扩大			
savory	美味可口的；令人愉悦的			
drone	单调地说；嗡嗡叫；混日子			
pensive	哀思的			
meticulous	a.极为谨慎的			
inimitable	无法效法的独特的			
phenomenal	不同寻常的，非凡的			
synonymous	同义的			
crucial	非常重要的			
barter	以物易物			
flounder	笨拙地移动			
finesse	娴熟技巧；精心策划；躲避			
paranoid	多疑的，对他人极端恐惧和多疑的			
vindicate	为……平反；证明			
discrete	离散的			
splutter	急切而不清楚地说			
belabor	当众批评；喋喋不休			
dissolve	溶解；融化；解散；消失；废除			
truss	系紧 扎紧			
rabid	疯狂的，不冷静的			
distend	膨胀			
whimsical	反复无常的			
petroglyph	岩石雕刻			
industriousness	勤勉			
monochromatic	单色的；单调无聊的			
smart	反应敏捷的；整洁的；感到疼痛			
irreducible	不可约分的			
smug	自大的；整洁的			
adulate	极度谄媚			
pan	严厉批评			
acquire	获得			
malign	a 恶意的；vt 诽谤			
sprawl	蔓延；杂乱无序地发展			
maelstrom	n 漩涡；n 混乱动荡的局势			
ennui	厌倦			
efficacious	有效的			
mettle	n.勇气；n.毅力			
ingrained	本质的；根深蒂固的			
diminish	减少			
enmity	敌意			
stench	恶臭			
provincial	狭隘的			
sprightly	活泼的，充满活力的			
effrontery	厚颜无耻			
tint	涂浅色；微染			
brittle	易碎的；不真诚的			
enervate	使衰弱			
barren	不育的；无效的			
shifty	狡诈的			
fanciful	幻想中的；荒谬的			
petition	请愿;申请书；请求			
consign	移交转移			
seemly	得体的			
overshadow	使变暗淡；超过			
cornucopia	大量			
frivolous	轻率的；不重要的			
pirate	盗版盗用；海盗			
inveterate	积习的			
tangle	困惑；纠缠			
abase	降低			
bombast	自夸之词			
preempt	预先占有；替换			
consequence	重要性			
indelible	擦拭不掉的；无法忘怀的			
ferocious	剧烈的；爆发性的；凶猛的			
tenable	无懈可击的；有据可依的			
beholden	欠他人人情的			
miscreant	恶棍			
agrarian	农业的			
stock	库存；普通的			
revoke	撤回，宣布无效			
rubicund	红润健康的			
persevere	坚持不懈			
prohibitive	禁止的；价格过高抑制购买的			
mordant	尖酸刻薄的			
indifferent	不感兴趣的；公平的；一般的			
mitigate	减轻；使缓和			
gasification	气化			
bound	界限；给�设置障碍；投入的坚定的			
scruple	良心上的不安			
descendant	后代			
pusillanimous	懦弱的			
wretched	沮丧的；极差的			
forage	寻找			
scuff	磨损；脚步拖沓			
privation	贫困			
wrest	扭动、拧；辛苦获得			
rash	仓促的			
vile	丑陋的；卑鄙的			
expedition	动作迅速			
gourmand	大胃王			
annotate	给……做注解			
plumb	测定深度；垂直的；仔细地检查			
pessimism	悲观			
cosmopolitan	有世界眼光的			
caricature	讽刺画；嘲笑性模仿或夸张			
misapprehension	错误的理解			
revelry	狂欢			
prosperous	繁盛的			
evince	表明			
ordeal	严峻的考验			
sanctify	使神圣			
salubrious	有益健康的			
assert	断言			
besmirch	诽谤；玷污			
surfeit	过量；饮食过量			
faze	打扰；使气馁			
rescind	废除			
infatuate	使迷恋			
provisional	临时的			
conditional	有条件的			
consonant	和谐一致的			
polarize	两极分化			
lag	最终的；缓慢行走；失去活力			
dissect	仔细分析；切成片			
baffling	令人疑惑的，难以理解的			
detour	偏离正常线路标准；绕道			
measly	a 少的可怜的			
stealth	秘密行动；秘密的			
charlatan	骗子			
annul	宣布无效；抵消			
barefaced	厚颜无耻的			
uncanny	离奇的			
grovel	卑躬屈膝			
pioneer	先驱者 拓荒者；最初的；开创			
interim	中间过渡时期；暂时的			
clamor	喧闹			
turncoat	叛徒			
epitomize	摘要；是……的典范			
raze	摧毁			
invidious	惹人反感的；羡慕嫉妒恨的			
eavesdrop	窃听			
hovel	茅屋			
hearken	倾听；关注			
indict	起诉			
merited	a. 应得的			
signal	非同寻常的；发出信号			
eulogize	称赞			
wane	减少			
posture	故作姿态			
palatable	感到愉悦满足的			
mandatory	a 强制的			
duplicity	欺骗			
barbarous	凶残的；未开化的			
vituperate	谩骂、责骂			
vertigo	眩晕			
hone	磨快			
terse	简洁的			
digress	脱离主题			
satiate	饱足			
axiomatic	公理的；不言自明的			
faction	派系			
apprehension	恐惧；逮捕；理解			
squall	暴风雪暴风雨；尖叫			
chivalrous	有骑士风度的，对女性彬彬有礼的			
heterodox	异端的			
onset	攻击；开始			
humble	谦逊的，顺从的			
irradicable	不能根除的			
domineer	专制统治			
deify	奉为神；崇敬；过分喜爱			
lush	a 茂盛的；多产的；（声音、味道）令人愉悦的			
dart	突然飞驰；公开侮辱			
permanence	永恒			
piquant	辛辣开胃的；令人振奋的			
pucker	撅嘴			
alchemy	炼金术			
fecund	多产的			
babble	胡乱说；闲聊			
conspicuous	显而易见的			
egoism	利己主义			
insubordinate	不服从权威的			
disjunctive	分离的			
wince	畏缩			
charisma	魅力 吸引力			
repugnant	令人厌恶的；不和谐的			
vilify	诽谤			
promulgate	正式宣布			
affectation	虚伪做作			
gloat	自鸣得意，幸灾乐祸			
forthright	直率的			
stonewall	拒绝合作，阻挠			
immaterial	非实体的；不重要的			
dichotomy	一分为二，分割			
placebo	安慰剂			
misbehave	行为不端			
coop	囚禁			
panegyric	颂词			
bumble	含糊不清地说；笨拙地行动			
prowl	巡游以猎取食物；徘徊			
rickety	不稳的			
decadent	堕落的；放纵的人；道德堕落的人			
compunction	内疚、良心不安			
coerce	强制			
extract	用力拔出			
solitude	孤独			
asymmetrical	不对称的			
equity	公平			
gorge	峡谷；狼吞虎咽			
thick-skinned	冷漠无情的			
discretionary	自主决定的			
vindictive	复仇的			
creek	小溪			
sloth	懒惰			
naysay	拒绝			
compendium	摘要；目录、纲要			
chide	责备			
saunter	闲逛			
retract	收回；否认			
bedeck	装饰			
gregarious	爱社交的；群居的			
purvey	大量供给			
imprecise	不精确的			
personable	风度翩翩的，吸引人的			
premeditate	预谋			
sybarite	奢侈淫乐者			
defy	反抗			
quaver	发颤音			
zeal	热心			
meet	a 合适的			
hideous	非常丑陋的			
intoxicant	使人醉的东西			
irritate	刺激惹恼			
yokel	天真淳朴的人，乡下人			
decry	否定			
perturb 	扰乱			
traverse	横穿			
ratify	批准			
ruthless	残忍的			
toy	草率不认真地对待			
boo	嘘			
abnegate	否认；交出权力			
stickler	坚持细节的人，一丝不苟的人			
sporadic	偶尔的；零星发生的			
pathological	不正常的，病态的			
askew	歪的			
ribald	举止、言语粗鲁的			
contravene	反对			
chord	符合；与……和谐一致			
cherished	珍爱的			
truant	逃避责任的			
opportune	合适的			
scrutable	可理解的			
linger	vi.磨蹭，闲荡			
mint	铸造；巨额；无损坏的			
rue	后悔			
reverberate	回响回荡			
exhort	力劝督促			
curtail	缩短			
numb	麻木的；无感情的			
magnificent	a 壮丽的			
incendiary	煽动者			
interminable	无尽头的			
posit	断定			
obstinate	固执的；难以减轻或治愈的			
pompous	浮夸的；傲慢的			
puerile	幼稚的			
bibliography	文献目录			
shrug	耸肩；轻视忽略；脱下			
mite	微小的东西			
motley	混杂的富于变化的			
teetotalism	禁酒			
appreciable	可感知的，明显的			
lissome	a.柔软的；a.敏捷轻盈的			
chase	镂雕以装饰；驱赶			
admonish	建议；责备			
impend	即将发生			
unimpeachable	无可置疑的			
hypothetical	假设，前提条件；假定的			
doze	打盹儿、小憩			
countenance	容忍；赞成 推崇；沉着冷静			
subvert	颠覆			
surly	脾气不好的			
tangent	离题的；不相关的			
contiguous	接壤的			
cajole	哄骗			
clout	权力			
misanthrope	厌恶人类的人			
perpetual	永恒的			
corrugated	褶皱的			
tractable	易驾驭的温顺的			
charade	装模作样；动作字谜			
gear	调整以配合			
green	无经验的			
serene	镇静的，安静的			
offhand	即兴的			
impromptu	即席的；即席表演			
canny	精明的			
infirm	虚弱的；优柔寡断的			
solidify	凝固			
precipitous	非常陡峭的；匆忙的			
scrappy	好斗的			
nautical	航海的			
contempt	蔑视			
lance	标枪长矛；刺穿			
pilot	飞行员；初步实验性的；带领通过			
refine	提炼；改善改进			
sling	投掷			
marsh	n 沼泽、湿地			
churl	粗野的人；吝啬鬼			
retentive	记性好的			
zenith 	最高点巅峰			
orthodox	正统的；传统的			
pejorative	轻蔑的贬低的			
defer	推迟；遵从			
calumniate	诽谤			
topsy-turvy	混乱的			
verbatim	逐字的，一字不差的			
unruly	难驾驭的			
torpid	麻木的；迟钝的行动迟缓的			
referee	仲裁者；就纠纷给出意见			
nomad	游牧民；游牧的居无定所的			
exodus	大批离去			
platitude	陈词滥调；缺乏原创性			
snub	轻视			
baleful	有害的；凶恶的；致命的			
impeccable	无可挑剔的；无罪的			
loquacious	a.话多的			
remonstrance	抗议，抱怨			
inundate	淹没			
badinage	打趣、善意的玩笑			
reserved	矜持的，缄默的			
encompass	包含；包围			
disdain	鄙视			
evanescent	短暂的			
negotiate	谈判；谋划			
homogenize	同一化			
acknowledge	承认			
sinew	活力，力量			
cascade	小瀑布			
crutch	支柱支撑			
painstaking	煞费苦心的			
accessible	可达到的；可理解的；能获得的			
gripe	抱怨；惹怒			
channel	水渠；海峡；投入			
original	创新的；最初的			
extraneous	无关的；非主要因素的			
earsplitting	震耳欲聋的			
chorale	赞美诗；合唱班			
nostalgia	思乡之情；怀旧			
contract	收缩；契约			
discord	不和谐			
lionize	追捧			
succumb	屈服；死亡			
imperturbable	沉着冷静的			
groove	享受			
inert	惰性的；缺乏活力的			
buck	反对；转移			
sap	削弱；健康 活力			
opprobrious	辱骂的；臭名昭著的			
fluke	侥幸			
inculpate	归罪于			
knead	揉捏塑造			
expansive	广阔的；健谈的			
dismay	使失去信心			
windbag	健谈的人			
accrete	逐渐增长			
subliminal	下意识的			
backhanded	间接的，含沙射影的，虚情假意的			
elude	躲避；使困惑			
impiety	不敬神；无信仰			
observant	警惕的；严格遵守的			
pittance	少量津贴			
lassitude	乏力			
intangible	无法感知的			
sophistication	精明			
brisk	有活力的；刻薄的			
hesitance	犹豫			
beset	困扰；袭击			
serendipity	意外发现珍奇事物的本领，缘分			
excruciate	折磨			
innocuous	不会引起恶意的；无害的			
incontrovertible	无可争议的			
inveigle	诱骗			
sordid	肮脏的；卑鄙的			
repeal	撤销；废除；宣布与……决裂			
annex	裙楼；添加合并；吞并夺取			
adversary	对手			
intimate	亲密无间的；密友；暗示			
rudimentary	初始的；最基础的			
tender	正式提出；考虑周到的关心的			
legend	传奇；图例			
jolt	突然移动；惊吓			
diligent	勤勉的			
quarantine	隔离			
nil	零；不存在			
renovate	革新恢复			
aspirant	有抱负者；想成为……的			
quail	畏缩			
conversant	熟悉的			
hymn	极老的			
convoke	召集开会			
license	许可；自由；放荡；准许 授权使用			
versed	熟知的；精通的			
dogma	教条、信条			
oxymoron	矛盾修饰法			
infinite	无尽的			
blithe	愉快的			
amble	漫步			
vendor	小贩			
tirade	长篇抨击性演讲			
repose	休息；平静；交给他人			
demanding	难取悦的；费时间花心思			
frothy	用轻薄材料制作的；不严肃的欢乐的			
obstruct	妨碍；阻挡			
querulous	抱怨的，爱发牢骚的			
menace	vt 威胁			
awkward	笨拙；不优雅；处理问题缺乏智谋			
canonize	过分宠爱崇拜；使崇高			
chicanery	诡计、欺骗			
sincere	真诚的			
punctilious	包袱			
fervent	热情洋溢的			
awning	雨篷；遮阳篷			
parsimonious	吝啬的			
discredit	羞辱；怀疑			
bluff	直率的；欺骗			
coarse	粗糙的；刺耳的；粗俗的；低劣的			
delicacy	精致			
deterioration	恶化			
oust	驱逐；免职			
abysmal	极低的；极可怜的			
marginal	边缘的；不重要的			
want	短缺；渴望			
juggernaut	摧毁一切的强大力量			
natty	整洁的			
convex	凸起			
canon	标准；真经正典			
terminus	终点			
incentive	刺激，诱因			
virtuous	品德高尚的、正直的			
capitulate	投降			
harangue	发表长篇大论			
surmount	战胜			
strip	脱去			
substantive	本质的			
nondescript	平凡的			
respire	呼吸			
mesh	v. 诱捕			
tyro	新手；业余爱好者			
abuse	辱骂抨击；不合理使用；过量使用			
palaver	对话；闲聊			
furtive	秘密的			
ham-handed	笨手笨脚的			
stodgy	平庸的；非常守旧的			
cowardice	懦弱			
ponderable	有价值的，值得考虑的			
cavort	雀跃			
ambrosial	特别美味的			
intemperate	无节制的极端的不温和的			
depose	发誓作证；罢免；摆放			
flamboyant	艳丽夺目的			
patent	显著的			
synthesis	合成			
iniquity	邪恶，不公正			
august	庄重的；盛大的			
engender	引发；出席			
unlettered	未受教育的，文盲的			
perquisite	额外的好处			
hanker	向往；渴望			
cumbersome	笨重的			
censorious	挑剔指责的			
swindle	欺骗			
regress	后退；恶化退化			
bale	痛苦			
gratuitous	无依据的；无报酬的			
stabilize	使稳定			
heinous	可憎的			
fleet	快速通过；舰队车队；迅速的			
transfigure	改观			
glutinous	胶状的			
quibble	吹毛求疵；小反对			
limp	a.柔软的；a.没有精神的；vi.艰难地行走			
meddle	vi 干涉			
contort	扭曲			
parry	躲避			
restrain	限制			
mute	使�柔和；减弱声音；缄默的			
rectitude	公正			
onerous	繁重的；费时间花心思的			
lumber	n 木材；vi 笨拙地行动；vt 增加负担			
nefarious	邪恶的			
preen	整理羽毛；打扮装饰；自满			
protocol	正确的礼节			
demonstrate	证明			
macabre	a 恐怖的			
spindly	细长纤弱的			
verbose	冗长的			
predilection	爱好			
redoubtable	令人尊敬的；可怕的			
pacify	使平静；安慰			
deluge	大暴雨；大量			
ensconce	安置；隐藏			
preach	传道			
cunning	狡猾的；灵巧的；欺诈欺骗			
frugal	节约的			
gauge	测量标准；判定			
corrosive	腐蚀的；讽刺性的			
panacea	万能药			
impede	阻碍			
resign	辞职			
rostrum	讲坛			
narcissism	自恋			
incipient	起初的			
transitory	短暂的			
sip	啜饮			
leery	怀疑的			
bristle	怒不可遏；充满			
tentative	暂时性的，尝试的			
shoal	浅的			
misgiving	担忧			
nitpick	吹毛求疵			
uphold	支持			
temerity	鲁莽			
agonize	使非常痛苦			
pundit	权威人士，专家			
insular	孤立狭隘的			
remnant	残余物			
confront	直接对抗			
prairie	大草原			
mongrel	杂种的；混血的			
paragon	优秀模范；把……比作			
substantiate	证实；使实体化			
lithe	a.柔软的；a.敏捷轻盈的			
vitriolic	刻薄的			
flock	鸟群；兽群；聚集			
theatrical	做作的；夸张的			
douse	熄灭；弄湿			
calibrate	调整使标准化；精确测量			
canvass	仔细检查；拉选票或订单			
draconian	极其残酷的；十分严厉的			
plateau	稳定时期；高原			
preponderant	占优势的			
ream	训斥			
agitate	煽动；使不安			
gangly	身材瘦长的			
retrospective	回顾的			
protuberant	凸出的			
elate	使开心			
coagulant	使凝结、变稠			
domination	支配			
paean	欢乐颂			
voluptuous	奢侈淫乐的			
filibuster	拖延议事			
ambivalent	矛盾的			
reticent	沉默不语的；不愿意的			
iconoclast	特立独行的人			
glutton	贪吃者			
profane	亵渎；滥用			
disenchant	使清醒			
watershed	转折点，重要关头			
scads	大量			
speculate	推测；投机倒卖			
ingenious	聪明的			
reap	收割收获			
hallmark	典型的特征			
ballet	芭蕾舞			
diabolic	恶魔一般的			
grit	毅力			
fester	溃烂			
erode 	侵蚀			
intelligible	可理解的			
surreptitious	偷偷摸摸的			
peculiarity	特征			
swagger	大摇大摆地走；自夸			
calamity	大灾难			
precipitate	加速促进；仓促的			
intrigue	激起�的兴趣；阴谋			
counterfeit	仿制的；仿制；伪装成			
wizen	凋谢；枯萎的			
imitation	模仿；仿制品			
oscillate	震动；犹豫			
tenuous	没有实际内容的，空洞的			
approbation	同意；赞许			
seminal	有发展性的；创新的			
importune	恳求 迫切请求			
blunt	使变钝；减弱；直率的			
blasé	厌倦享乐的			
proclaim	宣告			
vignette	简介、短文			
pertain	适合；属于；有关联			
mosaic	镶嵌图案；综合物，马赛克般的东西			
taciturn	沉默寡言的			
fastidious	挑剔的 			
loll	vi.懒洋洋地行动；vi.偷懒			
fetter	束缚；枷锁限制			
soak	浸泡			
edifice	大厦；基础			
requite	酬谢；报答；报仇			
latitude	自由			
abreast	并排的；熟知的			
replenish	补充			
debase	贬低			
inaugurate	使就职；开始			
disaffected	不满的、叛逆的			
exploit	英雄行为；最大程度利用			
premeditate	预先考虑			
laconic	简洁的以至于显得粗鲁的			
conserve	保存			
torrential	急流的			
insensitive	缺乏机智圆滑的；麻木的			
exacerbate	使恶化			
colossal	巨大的			
accessory	辅助的；帮凶			
malicious	a 恶意的			
simulate	模仿；模拟			
static	静态的；不易改变的			
inquisitive	过分好奇的			
stigmatize	使蒙受污名			
intrinsic	固有的内在的			
blandishment	以甜言蜜语哄骗			
abiding	永久的			
rend	撕裂			
obviate	排除			
scour	用力擦洗；搜查			
scrutinize	仔细检查			
excoriate	严厉批评			
boggle	因为怀疑而犹豫；笨拙地做			
craven	胆小得令人鄙视的			
sluggard	懒鬼			
raffle	垃圾废物			
avid	急切渴望的；贪财的			
accede	赞成；就职			
influx	涌入			
cohesive	有粘性的；有凝聚力的			
cosset	宠爱			
evasive	含糊其辞的；难以发现捕捉的分离的			
earnest	严肃认真的			
correlate	使……相关联			
equivalent	等价的			
frustrate	挫败；使沮丧			
claim	要求；对于�的权利			
ingenuity	独创性			
confine	禁闭；限制			
proofread	校对			
infelicitous	不幸的；不恰当的			
dilute	稀释；削弱			
malcontent	n 不满分子；a 不满的			
idiosyncrasy	独特而奇怪的习惯			
construct	建造			
conflate	混合			
scorch	烘干，炙烤			
predecessor	前辈			
deploy	展开；调度部署			
crook	使弯曲			
distill	用蒸馏提纯；渗出滴下			
wanderlust	旅行癖			
gaudy	俗丽的			
hypocritical	伪善的			
fad	流行，时尚			
sparing	节俭的；不足的			
vaunt	吹嘘			
blatant	喧哗的；非常明显的			
fitful	无规律的			
nourish	养育；培养促进			
efface	擦掉			
odium	憎恶			
explicate	解释说明			
inanimate	无生命的			
crux	中心			
piddling	微不足道的			
conjure	恳求；想起			
dilettante	业余爱好者缺乏专业技术的			
vulgar	粗俗的；口头的非正式的			
erudite	博学的			
reproof	批评反对			
effervesce	热情洋溢；冒泡			
sycophant	马屁精			
trumpet	大声说出或宣告			
scoff	嘲笑；狼吞虎咽			
vicissitude	自然变化、变迁兴衰			
autonomy	政治上的独立；精神上的独立、自我主导的自由			
topsy-turvy	混乱不整洁的			
opine	表达观点；认为			
elliptical	含糊不清的；椭圆的			
diffident	不自信的；沉默的内向的			
thwart	阻挠			
agility	敏捷			
fallow	休耕的；闲置的			
purloin	偷窃			
extinct	灭绝的			
prodigious	巨大的；惊人的了不起的			
archetype	典范；鼻祖；原型			
acrid	辛辣的；刻薄的			
fulminate	大声斥责			
acclimate 	使适应			
bolster	支持；鼓励			
sonnet	十四行诗			
weather	经受住			
philistine	市侩（注重物质而鄙视智慧或艺术的人）			
surrogate	替代品			
demoralize	使士气低落			
retaliate	报复			
laudatory	表示赞扬的			
temporize	行动躲躲闪闪以争取时间、躲避争论等			
menial	仆人；卑贱的			
haven	安全的地方			
occult	隐藏的；难以理解的；使隐藏或神秘			
copious	丰富的			
sterile	贫瘠的；无菌的			
humility	谦卑			
foolproof	十分简单以至于不会失败的			
sabotage	妨害；破坏；阻止			
proliferate	快速繁殖；激增			
supposition	猜想			
sand	磨光；沙			
satire	讽刺诗，讽刺文学			
carnal	肉体的；世俗的			
sequel	结果			
inclement	恶劣的；无情的			
irate	极其愤怒的			
grin	咧嘴笑			
insentient	无感觉的；一知半解的			
scurvy	下流的			
ratiocination	推理			
immature	未成熟的			
conservatory	艺术学院；温室			
abdicate	正式放弃			
euphemism	委婉语			
mockery	鄙视；用以嘲笑的模仿			
preposterous	荒谬的			
forge	伪造；锻造铸造			
supplant	排挤；篡夺位置			
lugubrious	a （故作夸张的）悲哀的			
wax	增大；月亮渐满；上光			
lachrymose	催人泪下的			
genial	和蔼可亲的；友好的；温暖的			
derelict	玩忽职守的；被社会遗弃的人			
elaborate	详细的；详细说明			
somber	忧郁的；昏暗的			
hubris	狂妄自大			
advert	引起注意、提到			
medley	a 大杂烩、混合物			
dank	阴湿的			
ardor	狂热			
stoke	添加燃料；促进			
vapid	无趣的			
moratorium	延期、暂缓施行			
petulant	易怒的			
pandemic	大规模流行的			
convenience	便利			
deride	嘲弄			
refractory	倔强的，不顺从的			
nugatory	无关紧要的			
parody	模仿以嘲弄			
lopsided	a.歪的；a.d不协调的			
sedate	镇静的			
perspicuity	清晰明了			
segment	分割；部分			
epigram	警句、机智的短诗			
sanctuary	避难所			
vex	使烦恼			
animate	活的；有活力的；使有活力			
fertilize	使肥沃			
procure	获得			
founder	完败；沉没			
callow	不成熟的			
rife	丰富的、普遍的			
disgruntle	使发怒			
stalwart	健壮的；无所畏惧的；坚定地			
assail	抨击；攻击			
depreciate	贬值；轻视			
sidestep	不遵守			
ken	视野范围；知道了解			
arrogance	傲慢			
abominate	憎恶			
jog	慢跑；唤起			
orient	确定方向			
circumlocution	绕圈子的话；冗长			 
nerve	鼓起勇气；意志勇气			
supercilious	高傲的			
quell	压制；平息			
noisome	有毒的；恶臭的；非常讨厌的			
liken	v.把……比作			
waft	飘荡			
sedentary	固定不动的			
sensation	感觉；轰动事件			
extrapolate	逻辑推断			
annoy	不断烦扰			
scathing	尖酸刻薄的			
precarious	危险不稳定的；可疑的			
contemplate	沉思			
camouflage	伪装；隐瞒			
fickle	易变的；不忠诚的			
mania	n 热衷、狂热			
vicarious	代理的、取代的			
errant	误入歧途的；居无定所的			
acerbic	尖酸的			
sin	罪恶的事			
flaccid	松弛的			
boycott	联合抵制			
transparent	透明的；清晰易懂的；坦率的			
alibi	不在场证明；借口托辞			
ensue	紧随其后			
agog	极度感兴趣的			
airtight	无懈可击的；不透气的			
padding	废话、夸张			
alienate	疏远；转移、变卖			
humiliate	羞辱			
plight	困境			
varnish	上清漆；粉饰			
snare	捕捉；无法逃脱的困境			
fidelity	忠诚			
migratory	a.迁移的			
protean	善变的；多才多艺的			
phlegmatic	冷静的，冷漠的			
urbane	彬彬有礼的			
cliché	陈词滥调的			
perimeter	周长，边界			
fantasy	幻想			
cameo	栩栩如生地描绘或刻画；客串			
ominous	凶兆的			
supple	易弯曲的，柔软的			
taint	使污损			
appall	使惊恐			
inducement	动机；劝说			
aggrandize	增加；提高			
insouciant	不在乎的不纠结的			
plodding	走路沉重缓慢的			
disavow	拒绝承认			
prowess	英勇			
ubiquitous	无所不在的			
trudge	吃力而笨拙地走			
instigate	煽动			
disinterested	公正的；不感兴趣的			
jot	简要记录			
exorcise	除去			
equable	温和的			
specific	特有的；明确的			
nocturnal	夜间的；夜间活动的			
teeming	大量的			
crease	折痕			
frail	虚弱的；意志薄弱的；渺茫的			
categorical	绝对的，没有例外的			
sound	稳固的；健康强壮的；逻辑严谨的			
visionary	空想的；幻觉的；有远见的			
baffle	挫败阻挠；使疑惑			
deplete	耗尽			
trivial	微不足道的			
prescription	处方；规定			
paramount	最重要的			
inadvertent	偶然发生的；不留意的			
delirium	精神错乱；发狂			
fragile	易碎的；脆弱的			
patriot	爱国者			
dogged	坚决的；固执任性的			
carouse	畅饮			
bacteria	细菌			
comity	友好和谐			
renounce	声明放弃			
hamstring	使无效			
elastic	有弹性的；能恢复的			
propitious	吉祥的			
plunge	突然下降；插入刺入			
hard-bitten	顽强的			
tame	被驯化的；无聊乏味的；抑制控制			
venom	毒液；恶意			
relentless	残酷无情的；固执不妥协的			
pulchritude	美丽			
smarmy	虚情假意的			
astounding	令人吃惊的			
apprise	通知			
tyrant	暴君			
embroider	用刺绣装饰；伴有夸张的详细说明			
obsess	迷住；使困扰			
stymie	阻碍			
apocryphal	假的			
jitters	紧张不安			
desultory	散漫的无计划无目的的；令人失望的			
stratagem	谋略			
ad-lib	即兴的			
gull	欺骗			
eclat	辉煌成就			
infamous	声名狼藉的			
soporific	安眠药；催眠的；困倦的			
dent	凹陷；削弱			
thrill	兴奋快感；使兴奋激动			
rapacious	过度贪婪的；贪吃的			
vigorous	精力旺盛的；健壮的			
contend	竞争；声称			
squelch	压制；击溃			
obedient	服从的			
kidnap	绑架勒索			
paroxysm	突发；大动荡			
anemic	缺乏活力的			
resolve	决心，决定，分解			
shift	改变……的位置；改变；交换			
scintillate	才华横溢的；闪耀			
skirmish	小冲突			
halcyon	宁静的；繁荣的			
applicable	可用的可行的；相关的；合适的			
compliment	称赞恭维			
hackneyed	陈腐的			
unwonted	不寻常的			
debonair	无忧无虑的；风度翩翩的			
overt	公开的			
feign	制造假象			
dissolute	放荡的			
taunt	嘲弄性质疑			
humdrum	千篇一律；乏味的			
meretricious	艳俗的			
redistribution	重新分配			
vitality	活力；生命力			
ameliorate	改善			
ramble	漫步；漫谈			
spendthrift	败家子；挥霍的			
malodorous	a 恶臭的			
strut	趾高气扬地走；支柱			
chary	非常谨慎的			
emigrate	移民到海外			
eleemosynary	慈善的			
dire	悲惨的；不吉利的；恐怖的			
sanguine	乐观的；面色红润的			
protract	延长			
intimidate	恐吓			
beige	缺乏特征的			
dashing	爱冒险的大胆的			
accommodate	提供所需；调节以适应；使和谐			
shipshape	井然有序的			
pique	使愤怒；激起刺激			
timorous	胆小的			
dapper	衣冠整洁的			
dissuade	劝阻			
ravel	解开；阐明；使复杂化			
diversity	多样性			
unflappable	镇定的			
respite	休息，间歇			
threadbare	陈腐的；贫穷的；破烂的			
anonymous	匿名的；无特色的			
overwrought	十分激动不安；过分华丽的			
portentous	凶兆的；引发兴趣的			
commercial	商业广告			
hauteur	傲慢			
symbiosis	共生关系			
shadow	偷偷尾随；遮蔽使变暗			
concerted	共同完成的			
formidable	可怕的；艰难的			
illusory	幻觉的			
pristine	纯净的			
restitution	补偿赔偿			
plethora	过量			
filter	过滤			
prudent	明智的；小心谨慎的			
discomfit	使尴尬			
remunerate	给予报酬			
disarray	混乱			
exterminate	根除			
truncate	截短 缩短			
adversity	厄运逆境			
decant	轻轻倒出			
civility	彬彬有礼			
pitiless	没有同情心的			
austere	朴素的；严肃的			
refute	驳斥，证明为假；否认			
disregard	漠视；缺乏兴趣			
diverge	分歧；离题；改变方向			
brim	边界边缘；充满；加满			
conscientious	仔细的；正直的			
summary	摘要；立即的			
scission	切断			
fluctuate	波动			
entreat	恳求			
presage	预言；征兆			
aphorism	格言警句			
assiduous	勤勉的			
fringe	边缘；处于……的边缘			
doff	脱下			
venial	可宽恕的			
slight	纤细的；少量的；轻蔑；疏忽			
plummet	突然剧烈坠下			
gossamer	虚无缥缈的东西；轻薄的			
cache	囤货藏货；隐藏			
lethargic	没精打采的			
disseminate	传播			
petrify	使僵化、失去活力			
finale	终场			
figurine	小雕塑			
exonerate	免除责备			
accolade	同意；赞扬			
argot	隐语，黑话，行话			
acre	英亩			
attenuate	降低（数量力量价值）			
subsidy	补助金；津贴			
scowl	皱眉			
anachronistic	时代错误的			
indigent	贫穷的			
decrepit	虚弱的			
safeguard	保护措施；保护			
denigrate	诋毁			
stitch	突然剧痛			
discrepancy	差异或矛盾			
friction	摩擦；冲突不和			
content	满足			
malignant	恶毒的			
hale	强壮的；拖、拉			
perilous	危险的			
congruent	和谐一致的；全等的			
hybrid	杂交品种			
auspicious	好兆头的			
frowsy	邋遢的；味道难闻的			
cow	恐吓			
dramatic	显著的			
tangible	可感知的；确凿的			
convoluted	复杂的			
insolent	粗鲁的			
chameleon	善变的人；变色龙			
scurrilous	说粗话的			
epicure	美食家			
solder	连接联合			
magnitude	重要重大；巨大			
hamper	阻碍；有盖的大篮子			
affable	和蔼的			
winsome	迷人的			
knotty	多结的；困难的			
tightfisted	吝啬的			
inane	空洞的			
emancipate	解放			
extemporize	即席表现			
beseech	恳求			
asunder	分离成多片的			
abate	减轻；减少			
wag	诙谐幽默的人；摆动			
grotesque	难看的			
foreground	强调			
supersede	取代			
infuse	灌输；鼓舞			
sanction	批准；制裁			
augur	预言家；征兆预言；出现好兆头			
salve	减轻缓解			
tardy	缓慢的；延后的			
extravagant	挥霍的；过度的不必要的			
commencement	开始；毕业典礼			
spontaneous	"事先没有设计的,自发的"			
recluse	隐士；隐居的			
pertinacious	顽固的			
anthology	诗等的选集			
indemnity	保险补偿			
martinet	n 纪律严明的人			
profundity	深奥			
fawn	阿谀奉承			
strait	海峡；痛苦			
requisite	必不可少的；必需品			
cogent	令人信服的			
wheedle	哄骗			
herald	告知；预示			
cast	演员阵容；选派演员；提出；抛弃			
immune	有免疫力的；不受影响的			
spat	小争吵			
riveting	吸引人的			
shackle	束缚；阻碍限制			
seamy	堕落的；污秽的			
renegade	叛徒			
pontificate	傲慢地做或说			
extricate	使解脱			
shallow	浅薄的			
discriminate	区分；歧视			
crow	感到高兴；自鸣得意			
resilience	弹力；恢复能力			
effulgence	光辉灿烂			
credence	信任			
preclude	预先阻止；排斥			
indurate	使变硬；使习惯于；冷酷无情的			
quench	熄灭；使满足			
epithet	外号			
jarring	刺耳的;震惊的			
ennoble 	使尊贵			
demur	反对；犹豫			
revere	尊敬			
homely	朴素简单			
impugn	责难			
balm	止痛物；安慰物；香气			
arable	适合耕种的			
vehement	热情的；感情强烈的			
temperate	有分寸的；有节制的			
ingenuous	天真的；坦白的			
montage	蒙太奇；大杂烩			
tactile	有触觉的			
muffle	使消声			
gainsay	否认；反对			
reprove	温和地责备警告；不欣赏不喜欢			
royalty	版税；专利权税；皇家身份			
sage	智者			
temporal	世俗的			
manumit	vt 解放（奴隶）			
automatic	自动的；情不自禁的			
catalyze	催化导致			
assuage	缓和；平息；使满足			
tactless	不机智的			
resurrect	使复苏			
intrepid	无畏的			
rant	怒吼；长时间训斥			
jingoist	极端爱国激进分子			
military	军事的			
redolent	芳香的			
penalty	处罚			
compatible	一致的，能共存的			
outgrowth	结果			
savvy	老练机智；明确了解；精明能干的			
verse	使精通；诗歌			
tantalize	激起引诱			
damper	抑制因素			
grandstand	哗众取宠			
lullaby	n 催眠曲；vt 使安心			
cryptic	秘密的；含义模糊的；超出理解力的			
rhetorical	语言文字上的；辞藻华丽的（往往无内涵）			
imperious	专横的；爱发号施令的；迫切的			
coronation	加冕			
blight	枯萎；损坏			
esoteric	深奥难懂的；少数人知道的			
mar	n 污点；v 破坏			
accost	以挑衅形式搭讪			
raspy	声音刺耳的；容易生气的			
slouch	懒人；缓慢行走			
expedite	加快进程			
monopolize	垄断 主宰			
distal	远离中心的			
slate	列入名单计划			
vitiate	削弱损害；降低堕落			
retrograde	倒退的；退步退化			
septic	感染的，腐败的			
impostor	冒充者			
peep	一瞥；轻声			
stasis	平衡 停滞			
captivate	吸引			
dynamic	有活力的			
disgorge	呕出；被迫放弃			
abeyance	中止			
hyperbole	夸张			
wit	机智；智者			
clog	障碍物；障碍；堵塞			
surmise	推测；			
punctilious	注意细节的，一丝不苟的			
eccentric	古怪的人；行为古怪的			
sneer	轻蔑地嘲笑			
tedious	冗长乏味的			
court	追求			
negligent	疏忽大意的			
demote	降级降职			
quota	配额			
disinclination	不情愿			
incorrigible	不可救药的；无法管制的			
trenchant	锐利的；犀利的一针见血的			
pall	失去兴趣			
vim	活力			
impudent	无礼的			
harry	不断烦扰			
strident	刺耳的			
jabber	快而不清楚地说			
miff	vt.使恼怒			
imprudent	不明智的			
dilatory	拖延的			
brandish	威胁性地挥舞			
whet	磨快			
melodramatic	a 感情夸张的，伤感的			
refreshing	令人身心振奋的			
contagious	传染的；唤起共鸣的			
propriety	礼节；适当得体			
welter	混乱动乱			
turpitude	卑鄙			
sedulous	勤奋认真的			
spur	刺激；刺激物；支撑物			
voracious	有很大食欲的；贪婪的			
flaw	瑕疵			
rivulet	小溪			
sentinel	哨兵；看守			
wayward	刚愎自用的			
marvel	n 叹为观止的事物；v 因壮美等而惊叹			
intercessor	调停者			
peripatetic	巡游的，四处游历的			
lubricate	vt.使润滑			
outlandish	古怪的；奇异的			
gist	要点			
prestige	声望			
willy-nilly	不论是否愿意的；无秩序的随意的			
dupe	易受骗的人；欺骗；复制品复制			
byzantine	错综复杂的			
patronize	赞助；以高人一等的态度对待			
glide	轻松通过			
lank	细长瘦弱的；不僵硬的柔软松弛的			
dour	闷闷不乐的；严厉的			
dissonance	不和谐			
raffish	粗俗的			
sluggish	迟钝的；缓慢的			
drab	单调无聊的			
superimpose	添加			
adjourn	休会、延期			
incinerate	烧成灰烬			
override	不顾			
convert	改变信仰；改变转化			
comply	遵从			
surcharge	过高收费			
languor	衰弱；惰性 			
distract	转移兴趣；使分心；使不安；疯狂的			
manifest	a 显然的；vt 显露、呈现			
dodder	蹒跚			
descend	下降；世代相传			
tawdry	俗丽的			
wistful	（带着忧伤）渴望的怀念的			
trespass	非法侵入；违反冒犯			
victimize	使受骗；牺牲			
jibe	意见一致			
vouchsafe	允诺 给予			
purlieu	临近的地区；常去的地方			
vacillate	犹豫不决；摇摆			
devout	虔诚的			
anesthetic	止痛剂；麻木的			
mince	vt切碎；vi.小步走			
discommode	使不便			
taut	紧绷的；整洁的			
estimable	值得尊敬的			
irascible	易怒的			
glossy	平滑的；有光泽的			
enthrall	吸引			
intransigent	不妥协的			
truce	休战			
saturnine	忧郁的；讥讽的			
wily	狡猾的			
restless	不平静的			
vulnerable	易受攻击的、脆弱的			
disconcert	使不安			
tantamount	等价的；与�相等的			
combustible	可燃的；容易激动的			
polemic	争执			
leaven	在……中加入轻松活泼的因素			
squat	又矮又胖的			
veracious	诚实的；准确的			
bully	欺凌弱小者；最好的			
supplicate	恳求			
prevalent	流行的			
pigment	颜料；给……上色			
grumble	埋怨			
constringe	使狭窄			
ravish	使陶醉			
bravado	故作勇敢；虚张声势			
graft	移植			
undermine	削弱			
variance	不一致、不和谐			
conjecture	猜测			
smother	使窒息；压抑			
derivative	非原创的			
abhor	深恶痛绝			
mollycoddle	溺爱			
scion	子孙			
spoof	小恶搞；诱骗			
pastiche	模仿；大杂烩			
encumber	妨碍；给增添负担			
hedonism	享乐主义			
stolid	无动于衷的			
flippancy	无礼			
acclaim	称赞			
revolt	使厌恶；反叛			
rustle	快速地行动			
persistence	坚持			
indulgent	放纵的			
antagonize	敌对；激怒			
saddle	使某人负担			
sublime	崇高的；令人惊叹的			
squander	浪费；使分散			
census	人口普查			
misfortune	不幸			
swerve	突然改变方向			
acquisitive	贪婪的			
hack	雇佣文人；切割；乱砍开辟；成功完成；忍受			
depressed	意气消沉的；生活境况悲催的			
lamentable	悲哀的			
gobble	狼吞虎咽			
muddy	浑浊的；不干净的；使难以理解			
defile	山间小道；亵渎；污损			
spleen	怒气			
underscore	下划线；强调			
lament	悼词、抱怨；哀悼			
poseur	故作姿态、不真诚的人			
gall	激怒；深深的敌意；大胆无耻			
excavate	挖掘			
limpid	a.清澈的；a.淡定的			
credit	信任；表扬			
adulterate	掺杂			
concave	凹的			
ineffable	无法描述的			
abstemious	有节制的，节俭的			
alienate	使……疏远；转让			
accomplish	完成实现			
redeem	实践履行承诺；改过自新			
hilarious	非常好笑的			
prolix	_嗦的			
cleave	坚持；分隔 劈开			
lavish	大量的；挥霍的；挥霍			
goldbrick	逃避工作和责任			
cling	粘合；支持			
flatter	奉承；自我感觉良好；使显得漂亮			
cursory	匆忙的			
crescendo	声音渐强；顶峰			
extol	赞美			
syllogism	推理演绎			
severe	严厉的；艰难的			
coeval	同时代的			
wilt	植物萎蔫；精神萎靡			
vessel	管；船、舰艇			
belligerent	好斗的 好战的			
feckless	粗心的；无成果的			
penchant	强烈的嗜好，迷恋			
apparition	幽灵鬼魂			
penitent	悔过的			
pun	双关语			
halter	蹒跚；犹豫			
randomize	使随机化			
diaphanous	模糊的；几乎透明的			
daft	精神错乱的；不明智的			
smattering	浅薄的知识；少量			
serpentine	弯曲的			
exponent	倡导者；集大成者			
unwitting	不知道的未察觉的；偶然的			
gambol	雀跃欢跳			
countermand	撤销			
superfluous	多余的			
antedate	早于			
precipice	悬崖			
avarice	贪婪			
candor	坦白			
mottle	标记上杂色斑点			
particularize	详述			
nominal	不重要的；名义上的			
mire	陷入困境；困境			
sacrosanct	神圣不可侵犯的			
skittish	胆小的；容易激动的；善变的			
stockade	围栏；监狱			
episode	一段情节			
guzzle	狂饮			
extant	现存的			
prudish	过分守礼的			
inept	愚笨的；不恰当的；不称职的			
myopic	缺乏远见的			
garish 	过于鲜艳的			
cozen	欺骗			
mosque	清真寺			
discombobulate	使混乱使不安			
calculated	深思熟虑的			
exemplary	榜样的；作为警告的			
spent	精疲力尽的			
cachet	声望			
ineluctable	无法逃避的			
doldrums	低迷、中断；情绪不佳			
abbreviate	缩写			
excrete	排泄			
excursive	离题的			
abjure	发誓放弃；抵制			
scrimp	节俭			
nip	小口吃喝；少量			
deadpan	无趣的，无生气的			
enlighten	启发；进行精神或道德上的教育			
featureless	缺乏特征的			
votary	崇拜者			
prescience	预知			
acquisition	获得			
strength	强度；浓度；力量			
sacrilege	亵渎圣物			
bargain	交易			
self-absorbed	自恋的自私的			
insipid	平淡的；清淡无味的			
harsh	粗糙的；严厉的			
iridescent	彩色的			
ragged	衣衫褴褛的；凹凸不平不光滑的			
pliable	易弯曲的；易受影响的			
explicit	表达清晰的；成熟的			
somnolence	瞌睡			
constrict	压缩			
scribble	潦草地写			
zealot	狂热者			
bask	休息 悠然自得			
congeal	凝结			
bumptious	专横的；自大的			
initiate	创始；刚入门的新手			
servile	低下的卑屈的			
cacophony	刺耳的声音			
restive	急躁的；难以管束的			
dune	沙丘			
synergic	合作的			
quandary	困境			
mendacious	a. 虚假的			
flush	冲洗；肤色健康红润的；富有的；大量的			
libertine	n.放荡不羁者			
gloss	简短解释；光鲜外表；潦草地做事；开脱罪名			
reactionary	极保守的；保守者			
pariah	被排斥的人			
bane	祸根；有害的物质			
immemorial	古老的			
hymn	赞歌			
stipulate	特定要求，规定			
demotic	通俗的、大众化的			
carefree	无忧无虑的			
asperity	粗暴；艰苦			
subterfuge	托辞；诡计			
movement	乐章；运动			
inception	开始			
sodden	浑身湿透的；使湿透			
revise	校订修正			
histrionic	戏剧的；演员的			
stygian	极阴暗的			
unrequited	无报答的；无报酬的			
facile	肤浅的；容易的			
anomalous	反常的			
fluent	流利的；不费力的			
vivacious	活泼的			
periodical	期刊；周期性的			
doodle	乱画；漫无目的地打发时间			
bruit	散播消息			
disparate	迥然不同的			
bifurcate	使分成两支			
alleviate	缓和			
extort	勒索			
proponent	支持者			
scrap	抛弃；终止；废料废物			
strand	绳、线的一股；使置于困境之中			
voluble	健谈的			
hybid	贮藏			
abrade	磨损			
dimension	尺寸			
bravura	精彩表演（的）			
superficial	表面的肤浅的			
atrocious	极坏的；让人极为不满的			
quixotic	不切实际的			
stride	迈大步走			
glib	流利圆滑的；肤浅的			
germinate	发芽；出现			
insurgent	叛乱分子			
nirvana	彻底放松的状态；天堂 极乐世界			
prevail	盛行			
aggregate	集合体；集合			
despise	极不喜欢			
crumple	弄皱			
illiteracy	文盲			
apoplectic	极度愤怒的			
slumber	睡着			
hoodwink	欺骗			
volatile	多变的			
invigorate	使精神；使强壮			
dolorous	忧伤的			
pregnant	重要的；怀孕的			
squalid	污秽的；道德败坏的			
gust	情感爆发			
contrite	后悔悲痛的			
proclivity	偏好			
arbitrary	专横的；独裁的；随意的缺乏计划的			
rambunctious	喧闹的，骚乱的			
stifle	抑制；扼杀			
impertinent	无关紧要的；粗鲁无礼的			
recalcitrant	顽抗的			
testy	易怒的			
motto	座右铭			
guile	狡诈			
minimize	将�减到最少；刻意低估；鄙夷			
align	排成一排；校准			
adapt	使适应			
drivel	胡言乱语			
favoritism	偏爱			
rakish	放荡的			
camaraderie	友情			
banal	陈腐的			
attest	证实			
captious	吹毛求疵的			
wry	扭曲的；坚持错误的			
diatribe 	抨击性演说；挖苦			
fervor	热情			
omniscient	无所不知的			
imperial	帝王的；巨大的令人惊叹的			
catholic	普遍的			
noxious	有害的；产生强烈厌恶的			
crouch	蹲伏			
appropriate	私自挪用；恰当的			
deficiency	缺乏			
encomium	赞颂之辞			
elevate	提升；使兴奋			
concentrate	集中；浓缩			
convention	常规习俗；公约；大会			
exquisite	精致的；程度强烈的			
amicable	友善的			
exigent	紧急的			
maudlin	a 过于伤感的			
ignite	点燃；唤起激起			
jargon	行业术语			
prostrate	平躺；使衰竭			
brevity	简短			
decorum	礼仪			
deference	尊重			
sawdust	锯屑			
tatty	破旧的；褴褛的			
epic	宏大的，超凡脱俗的			
plastic	可塑的；虚假做作的			
barricade	阻止通过			
entangle	卷入；使变复杂或困难			
allude	间接提到			
agreeable	令人愉悦的；随和的；相一致的			
aloft	在空中			
heartrending	令人心碎的			
espouse	支持；拥护；与……结婚			
authority	权威；影响力；理由			
cognizant	知道的			
ethos	道德准则			
undergird	加强			
summon	召集；传唤出庭			
foil	挫败			
wan	苍白的；病态的			
quarry	采石场；目标			
credulous	轻信的			
slippery	光滑的；隐秘的；意义不明确的			
stiff	僵硬的；不自在的；过高的；艰苦的			
panoramic	全景的			
aseptic	消毒的无菌的；缺乏活力的；冷漠的			
aboveboard	光明正大的			
inveigh	激烈抗议			
veteran	老兵；有丰富经验的人；经验丰富的			
verisimilar	好像真实的			
limber	a. 可塑的，柔软的			
dissent	持异议；拒绝墨守陈规；不和谐			
reckless	不考虑后果的，大胆鲁莽的			
neutralize	中和；使无效			
partial	偏袒的；部分的不完整的			
ecstasy	无法自控的情绪；狂喜			
clumsy	笨拙的；不文雅的；不精致的			
prosaic	单调的常见的			
subside	下沉；减弱			
meager	a 贫乏的			
unexceptionable	无懈可击的			
rankle	激怒			
din	嘈杂声；使人厌烦地重复灌输			
grandeur	宏伟壮丽			
harness	利用			
salvage	抢救			
incubate	孵化；帮助培养促进			
innovation	创新			
amiable	脾气好、好相处的			
broach	开启；提出讨论			
legacy	遗产			
glower	怒目而视			
wickedness	邪恶			
probity	正直			
typo	打字错误			
brassy	厚脸皮的			
issue	流出；发行发布；议题			
complicate	使复杂化			
stricture	责难			
milieu	环境氛围			
choleric	易怒的；生气的			
bonhomie	温和			
arcane	晦涩的；深奥难懂的			
ceremonious	讲究礼节的 庄重的			
exorbitant	过度的			
tout	极力赞扬			
pliant	顺从的；易弯曲的			
bait	激怒；引诱；诱饵			
affinity	喜欢；相似			
turbid	浑浊的			
levity	轻浮			
absolve	赦免，解除责任			
partisan	信徒；支持者；偏袒的			
outwit	瞒骗；以智取胜			
carp	吹毛求疵			
pleat	打褶			
censure	公开反对、谴责			
suffuse	弥漫；染遍			
extinguish	熄灭；终止			
plausible	看似有道理的			
farce	闹剧			
futile	无用的；不严肃的			
invoke	实施；造成			
jovial	愉快的			
purity	纯净；纯洁			
waffle	胡扯			
obliging	乐于助人的			
lethal	致命的			
somatic	肉体的			
synchronous	同时期的			
tackle	着手处理			
buoy	使振作			
regenerate	洗心革面；焕然一新			
awe	敬畏			
inventory	存货清单；简介			
rampant	植物生长茂盛的；猖獗不受限制的			
figment	幻觉			
pluck	勇气；弹奏			
corona	日冕			
budge	改变立场；屈服			
anathema	宗教形式的诅咒			
pedestrian	行人；平庸的令人厌倦的			
stratify	将分成各种等级			
react	做出反应			
divulge	泄露（秘密）			
intermittent	间歇的；不定期的			
affix	粘合			
dispose	使倾向；处理掉			
refulgent	辉煌的			
harbor	提供住处；隐匿；心怀			
grandiloquent	浮夸的			
eschew	躲避；戒绝			
aloof	孤高的			
pragmatic	实用主义的 务实的			
oaf	愚蠢的人			
dullard	笨蛋			
interrogate	审问			
indispensable	不可缺少的			
mentor	n. 导师；n. 指导			
retrieve	找回			
devoted	投入的；恩爱的			
deportation	放逐			
impecunious	贫穷的			
enthusiasm	激情			
conform	使协调；调整；遵从			
conviction	确信；证明有罪			
lofty	a.崇高的；a.高的；a.自大的			
altruism	利他主义			
flexible	灵活的；易受影响的			
coquette	调情的女子			
mingle	混合；参加社交活动			
tantrum	勃然大怒			
downplay	轻描淡写			
feeble	衰弱的			
detain	拘留			
invincible	不可征服的			
lambaste	严厉斥责			
interlock	连锁连结			
bridle	限制			
forestall	预先阻止			
warp	使偏向；扭曲变形；曲解			
stereotype	成见			
imposter	骗子			
pretense	伪装；自大			
daredevil	大胆粗鲁的人			
virulent	有毒的，凶残的			
drizzle	毛毛雨			
cordon	警戒线；围成一道防线			
emboss	使突出；以浮雕效果装饰			
solid	固态坚固的；有理有据的；坚定的			
propitiate	抚慰			
paucity	少量			
verdant	翠绿的郁郁葱葱的			
jaundice	偏见			
mollify	缓和；平息抚慰			
prevaricate	支吾其词			
accelerate	加；使提前发生；变大			
palpable	摸得到的；明显的			
creep	缓慢地前进；匍匐前进			
veritable	真正的			
rupture	打破			
understudy	替补演员			
gratify	使满足；使高兴			
untenable	防守不住的			
backslide	倒退、故态复萌			
sullen	闷闷不乐的			
peruse	细读精读			
calligraphy	书法			
despotic	专制的			
exult	感到欢喜			
lug	vt 拖、拉；费力地搬运			
stoic	冷静的 隐忍的			
liability	责任；障碍 不利条件			
dread	恐惧			
goad	刺激、驱使			
covetous	贪婪的			
harass	烦扰；耗尽体力			
epitaph	墓志铭			
truculent	尖酸刻薄的；好斗的			
cipher	密码；无足轻重的人；计算			
machination	诡计			
wobble	摇晃；犹豫不决			
distraught	精神狂乱的			
list	v.（使）倾斜			
antithetical	完全对立的			
frigid	严寒的；冷漠的			
pedagogue	教师			
ecumenical	世界范围的；全球基督教会的			
euphoria	极其愉快的			
inkling	小提示；略知			
cherubic	天使般可爱的			
endeavor	奋斗；拼搏			
commingle	充分混合			
assertive	武断的			
placid	宁静的；淡定的			
stature	身高；才干水平			
inimical	不友好的有敌意的；不利的			
cellular	多孔的			
rage	暴怒			
footloose	无拘无束的			
repute	名声			
elegy	哀歌			
imbibe	喝水			
edible	可食用的			
ingratiating	讨人喜欢的；逢迎的			
salient	显著的			
belie	证明为假；掩饰；与……相矛盾			
nexus	连结；核心、最重要的地带			
hew	遵守;支持			
interdict	禁止；阻止			
hyperbole	欺骗			
nonsense	无意义的话废话			
mobile	可移动的；可变的			
compress	压缩			
splinter	刺、尖细条；切成细条			
commotion	骚乱			
resplendent	华丽辉煌的			
imperishable	不能被摧毁的；永恒的			
pitfall	陷阱；危害			
flit	快速经过			
presumptuous	放肆的；傲慢的			
sere	干燥的			
rejoice	欣喜			
abridge	缩短；缩写			
teeter	蹒跚；犹豫不决			
enfranchise	给予权力；解放			
allay	减轻			
duplicate	复制；重复；复制品			
genteel	有教养的			
wrongheaded	固执己见的，坚持错误观点的			
everlasting	永恒的			
offbeat	不平常的			
rookie	新兵；新手；菜鸟			
exculpate	开脱；声明无罪			
instate	任命			
lackluster	暗淡无光的			
faultfinder	吹毛求疵的人			
lurid	恐怖的；面色惨白病态的			
rave	狂热赞扬；怒吼			
veer	转向；改变航线			
blast	一阵强风；爆炸；抨击			
minuscule	极小的			
instill	慢慢滴入；灌输			
illustrious	著名的杰出的			
kindred	相似的			
fast	绝食；连接稳固的；忠诚的			
wholesome	有益身心健康的；卫生的			
chaos	混乱			
concord	一致			
vicious	恶意的；猛烈的			
mean	a 卑贱的；吝啬的  v 打算；意味着			
dabble	浅尝辄止			
rouse	激起，唤醒			
cloying	甜得发腻的；感情用事的			
croon	低声唱歌或说话			
depravity	道德败坏			
earplug	耳塞			
manipulate	vt 巧妙操作；暗中操作			
dissemble	掩饰			
chasm	分歧			
morbid	病态的；变态的			
obtuse	愚钝的			
appealing	吸引人的			
abstract	作总结；使分心			
expurgate	净化删去			
mediate	思索 沉思			
deign	不情愿地屈尊俯就			
entrance	入口；使入迷			
tepid	不太热心的			
worship	崇拜			
smuggle	走私			
remorse	懊悔			
fracture	破裂			
xenophobe	仇视或畏惧外国人者			
exacting	苛求的；费时间花心思的			
disinter	掘出			
whiff	微风；细微信号痕迹			
treacherous	背叛的			
adjunct	附属物			
haunt	常去拜访；不断想起			
coy	故作羞涩的；内向的			
commend	赞扬；委托保管；推荐			
kudos	名望；夸奖赞扬			
favorable	有利的；赞许的			
plentitude	大量			
synopsis	摘要			
grueling	筋疲力尽的；费时间花心思的			
petty	细微的			
nurture	提供营养；培养；促进			
speck	少量			
pinnacle	顶峰			
umbrage	不悦			
dubious	怀疑的；不愿行动的			
dispatch	迅速；派遣；使死亡；胜过			
vernacular	方言；非正式的口头的			
aggravate	加重恶化；使恼火			
panache	炫耀			
acumen	敏锐、洞察力			
loutish	a.粗鲁的			
palmy	繁荣的			
smirk	自鸣得意地笑			
consolidate	联合；加固			
obsolete	过时的；被淘汰的			
cower	畏缩			
lyric	n 小曲；a 如诗歌般的			
clan	有共同爱好的团体帮派			
fussy	挑剔的；谨慎的；过分雕琢的			
tamper	窜改；损害			
nebulous	模糊的			
harrow	折磨			
disarm	解除武装；平息抚慰			
peeve	惹恼			
incarnate	化身的；体现			
droll	古怪有趣的			
subject	受支配的人；取决于……的			
runic	神秘的			
considerable	数量可观的；值得考虑的、重要的			
ironclad	非常坚固的			
flourish	繁荣；装饰			
preeminent	优秀的，重要的			
recoil	退却			
desperate	绝望的			
peroration	结束语；演讲致辞			
incongruent	不一致的；不全等的			
facetious	幽默的；轻浮的			
ambiguous	含糊的、不确定的；有多种理解方式的			
implacable	不能和解的无法平息的；固执的			
rapport	和睦 友好			
partition	分割			
munificent	慷慨的			
conservative	保守的；低调的；谨慎的			
predestine	预先注定			
parenthesis	括号；间断			
delusion	错觉			
convey	运输；传递交流			
ignominy	耻辱			
tranquility	宁静			
project	方案；凸出；预测			
astute	机敏的			
mangy	a 卑劣的			
advocate	支持			
fictitious	虚构的			
venal	贪污受贿的			
motivate	激发			
warrant	向……保证质量；批准			
trepidation	恐惧			
reflect	反射；显露；思考			
saturate	浸透			
hearten	给予鼓励			
nonchalant	冷漠的			
consternation	惊慌恐惧			
prod	促使……行动			
disparage	贬低；轻蔑地说			
asylum	收容所			
incite	煽动			
usurp	篡夺；篡位			
puckish	淘气的			
excerpt	摘录			
divert	使转向；使消遣；使分心			
rive	撕开			
debark	卸货；下船、飞机等			
inconsequential	不合逻辑的；不重要的			
matriculate	v 入学；录取			
adjudicate	裁决判定			
spartan	简朴的，节约的			
manuscript	n 手稿			
brash	鲁莽的；不明智的			
exasperate	激怒			
dyspeptic	脾气坏的；消化不良的			
crestfallen	垂头丧气的			
deforest	砍伐森林			
tangy	刺激的			
indecorous	不合乎礼节的			
apathy	冷漠；不关心			
primordial	原始的			
potable	适于饮用的；饮品（尤指酒精饮料）			
ingest	摄入			
bore	令人厌烦的人或事物；使厌烦			
coda	终曲			
idyll	无忧无虑的生活			
lucid	a.易懂的；a.神志清醒的；a.有光亮的			
liberal	a.思想前卫的；a.慷慨大方的			
jettison	丢弃			
reel	感到眩晕；蹒跚走路			
obligatory	强制性的；（见得多以至于）无聊的			
defray	支付			
arrest	使不活跃，停止；逮捕			
veto	否决			
censor	审查；审查员			
savant	博学之士			
mutate	改变			
utter	出声；绝对的			
disguise	伪装；掩饰隐藏			
irk	使苦恼			
confound	混淆；使困惑；证明为假			
uncouth	粗俗的			
flout	嘲弄性不理会，蔑视			
unproductive	无效的			
bulge	凸起；比赛中的优势地位；突增；充满			
ancillary	辅助的			
roil	搅浑；激怒			
unctuous	油嘴滑舌的；夸张做作的			
discursive	杂乱散漫的			
dormant	静止的；冬眠的			
fledging	新手			
vigilant	警醒的、警惕的			
apocalyptic	预言的；重要的转折点的；夸大的			
contentious	引起争论的；好战的			
slovenly	邋遢的			
replicate	复制；重复			
residue	剩余物			
grate	发出刺耳声音；惹恼			
untoward	不吉利的；难以驾驭的			
dictate	指令命令；下令			
foreword	前言			
inch	慢慢移动			
delineate	勾勒；描绘			
behoove	对……有利			
flirt	调情；无规则地快速运动			
impuissance	无权			
bawdy	下流的			
incumbent	义不容辞的			
spurn	拒绝			
symphony	交响乐			
hike	上涨			
squint	斜视			
immutable	不可变的			
intuitive	直觉的			
plump	丰满的；鼎力支持			
terminology	专业术语			
transgress	违犯			
stipple	点刻；用点标记			
diurnal	白天发生的；每天的；期刊			
detritus	废品遗骸			
tumult	骚动 			
na_ve	天真纯朴的			
portfolio	投资组合			
provisory	有附带条件的；临时的			
compromise	妥协；使危险			
retard	减速延迟			
skirt	回避；边界			
profligate	挥金如土的；败家子；堕落的人			
aversion	非常讨厌；令人厌恶的事物			
trifling	细微的，不重要的			
reconnoiter	侦查			
indolent	懒惰的			
deadlock	僵局；使陷入僵局			
luminous	发光的；杰出的			
pervade	弥漫充满			
absolute	专制的；无限的；纯净的；确凿的			
extraction	血统			
ruffle	皱褶；弄皱；扰乱			
susceptibility	易受感染的性质或状态			
benign	好心的；无害的			
audacious	大胆的；无礼的；乐于冒险的；大胆创新的			
ostracize	驱逐			
gallant	英勇的；高贵慷慨的			
curt	言简意赅的			
mercenary	n. 雇佣军；a. 唯利是图的			
rehearsal	排练彩排			
ebullient	热情奔放的			
notoriety	因丑闻名的名人；坏名声			
prologue	序言			
sculpt	雕刻			
deracinate	根除			
coma	昏迷；迟钝冷漠			
awash	被淹没的；如洪水般泛滥的			
cardinal	主要的			
potentate	有权势的人			
incense	激怒；芳香			
awry	扭曲的；走样的			
protrude	突出			
dappled	有斑点的；色彩斑斓的			
prepossessing	给人好感的，有魅力的			
nonentity	不重要的人；虚构的东西			
mishap	不幸			
blazon	使知名，宣布；装饰			
off-key	不寻常的；不合适的			
dishearten	使沮丧			
steadfast	坚定的；忠诚的			
adhere	依附；遵守；坚持			
meander	vi 闲逛，漫步			
complaisance	彬彬有礼；顺从			
loath	a.不情愿的			
penury	吝啬；贫穷			
subtle	微妙的；巧妙的间接的			
mirth	欢乐			
eternal	永恒的			
reactant	反应物			
reprehend	谴责			
collapse	突然倒塌；完全耗尽体力；失败			
enact	制定颁布法律			
embargo	贸易禁止令			
prolong	延长			
interregnum	过渡期			
pseudonym	假名，笔名			
precipitation	降水；仓促			
fender	缓冲装置			
vociferous	喧哗的			
verify	校验证实			
comprehend	理解；包括			
parable	寓言			
sanctimonious	假装虔诚的			
erratic	缺乏连续性的；善变的；不同寻常的			
assess	评估；征收费用			
modicum	少量			
venerate	尊敬			
snarl	纠缠；咆哮			
autocracy	独裁政府			
denounce	公开指责			
reciprocate	往复运动；报答回报			
sermon	布道			
impenetrable	难以渗透的；难以理解的			
schism	不一致			
resolute	坚定的			
madcap	热爱冒险的人；大胆鲁莽的；			
dismantle	分解分拆			
disciple	信徒			
didactic	教诲的喜欢说教的			
erroneous	错误的			
hierarchical	等级制的			
articulate	明白清晰地表述；表达清晰的			
compose	使镇定；组成构成			
apposite	相关的；合适的			
proselytize	改变信仰			
tribute	颂词			
calibrate	校准			
clarion	清楚响亮的			
commonsensical	符合常识的			
discreet	言行谨慎的；不易察觉的			
hive	忙碌之地；储备积累			
succinct	简明的			
endemic	地方性的			
gash	很深的伤口；砍伤划开			
burlesque	恶搞			
fabricate	捏造			
agape	急切盼望的			
unassailable	无可争辩的，无可亵渎的			
taper	逐渐变细；减弱			
backfire	事与愿违			
pallid	无生气的；苍白的			
voyeur	窥淫狂			
blueprint	蓝图			
windy	冗长的			
debris	废墟			
oath	誓言			
warmonger	好战者			
exhilarate	使高兴			
etch	蚀刻；铭记			
achromatic	无色的			
coalesce	合并			
glitch	小故障			
salutation	致敬；赞扬			
proprietary	所有权；私营的			
forbearance	忍耐；友好仁慈的态度			
pivotal	最为关键重要的			
crave	热望			
rancor	敌意			
untold	数不清的			
dingy	肮脏的			
rationalize	合理化			
veneer	薄木板，用以贴在家具外面的饰面板；粉饰			
scotch	阻碍 停止			
macerate	vt 浸泡（以软化）			
detoxification	解毒			
preternatural	超乎寻常的			
peremptory	不容反抗的；傲慢的；爱发号施令的			
officious	多管闲事的			
inter	埋葬			
novel	新奇的；小说			
alacrity	反应敏锐；欣然			
desiccate	使干燥；使缺乏活力			
screen	屏障；保护；掩护			
pinpoint	精确定位；非常准确的			
husband	节俭 持家			
effete	衰弱的；懦弱的			
dally	虚度时光；磨磨蹭蹭；玩乐			
riot	喧闹；暴乱			
gush	大量涌出；感情强烈外溢			
postulate	假定为真；前提条件			
perfunctory	敷衍的；不感兴趣的			
bracing	令人振奋的；支持			
grandiose	自命不凡的；宏大的			
viscid	有粘性的			
slipshod	粗心的			
grudge	怨恨			
immanent	内在的			
halfhearted	不感兴趣的			
spurious	伪造的			
mannered	a 不自然的，做作的			
hallow	尊敬			
obeisance	敬礼尊重			
anterior	前面的			
shirk	逃避			
hegemony	霸权			
release	排放；释放；解雇			
sloppy	邋遢不整洁的；混乱的			
gourmet	美食家			
doyen	资深人士；高级会员			
epilogue	文学作品的结局；戏剧收场白			
mawkish	a 过度伤感的			
contumacious	不服从的			
solace	安慰安抚			
blackmail	敲诈勒索			
fatuous	愚笨的			
falsehood	谎言			
waylay	伏击；埋伏			
amenable	顺从的			
subservient	奉承的；屈从的			
disprove	反驳 证明为假			
talisman	护身符			
glut	过量			
inevitable	不可避免的			
flag	旗帜；变得衰弱			
compliant	顺从的			
languish	变得虚弱			
prate	闲聊			
constrain	限制；使人屈服于			
careen	蹒跚而行；狂奔 快速运动			
legion	大量的			
relish	偏爱；满足感；享受			
gauche	笨拙的			
corporeal	肉体的；有形的			
paltry	无价值的微不足道的；让人厌恶鄙视的			
measured	a 深思熟虑的			
enamored	迷恋的			
obdurate	固执的；冷酷无情的			
acrimonious	刻薄的			
demolition	破坏			
racy	活泼生动的			
secede	脱离、退出			
perceptive	敏锐的；洞察力强的			
momentum	动力；势头			
overlap	部分重叠			
abject	无精打采的；悲惨的；讨好的			
repress	镇压；阻止			
foible	小缺点			
stingy	吝啬的；极少量的			
palliate	减轻，平息			
affirm	声称肯定……为真			
scrawl	乱涂 潦草地写			
repulse	厌恶 排斥			
decadence	衰落			
repatriate	遣返			
deject	使沮丧			
stouthearted	大胆的			
sequester	使隔绝；使隐退			
aberrant	异常的			
culpable	有罪的			
connive	共谋；纵容			
ludicrous	荒唐可笑的			
vestige	微小的遗迹；小痕迹			
curriculum	课程表			
immure	监禁			
turbulent	汹涌的；动荡的			
evoke	唤起			
withhold	扣压、抑制			
dexterous	灵巧的；头脑灵活的			
fury	暴怒			
clandestine	隐藏的			
mulish	固执的			
splice	接合			
fortify	增强；做好心理准备			
swear	咒骂；宣誓			
aggrieve	使苦恼			
nuance	细微的差异			
tinge	给�着上少量的色彩			
paraphrase	意译，转述，改写			
inchoate	未完全成形的；新生的才开始的			
reconcile	使和谐			
placate	平息抚慰			
condole	表达同情或悲伤			
diehard	顽固分子；顽固的			
frenzy	疯狂			
humor	幽默；迎合			
inure	使习惯接受不好的东西；使坚强			
rapscallion	流氓			
dated	过时的			
resurgence	复兴			
distinctive	完全不同的；典型的			
minute	仔细的；小的不重要的			
turmoil	骚动 ，混乱			
adore	酷爱；宠爱			
responsive	反应快的			
shred	少量			
parity	相称，同等，平等			
dawdle	闲荡			
cloudburst	暴雨			
counterpart	对等的人或物			
idolatrize	盲目崇拜			
aver	声称为真；声明			
peripheral	外围的；辅助性的			
dandy	纨绔子弟；最好的			
stupor	迟钝；无知觉			
deprecate	不赞成不喜欢；贬低；使低调			
blemish	缺点；玷污			
roisterer	喝酒喧闹的人			
dissipate	驱散；浪费；放纵			
disinfect	消毒使无菌			
skeleton	骨架			
gadfly	刺激物；令人讨厌的人			
abstain	自我克制			
voluminous	卷数多的；大量的			
fatigue	疲惫；苦差事			
jocular	搞笑的			
allegiance	忠诚			
exalt	提升提拔；赞扬			
surrender	交出放弃；使沉溺于			
dissension	意见不合			
damn	谴责；非常地			
retinue	随行人员			
detach	分离			
prosecution	实行，执行			
amity	友好关系			
divestiture	剥夺			
novice	新手 			
rehabilitate	使复原康复；使洗心革面			
debacle	溃败			
lull	n 间隙的平静；vt 使安心			
maculate	vt 玷污；损坏			
run	连续演出			
understate	保守陈述			
obliterate	除去			
knit	编织；连接联系			
guilt	罪行；自责悔恨			
ungainly	笨拙的			
yoke	连接			
balky	倔强的，不服管束的			
fusty	过时的；恶臭的			
archaic	过时的			
scrupulous	正直的；一丝不苟的			
provoke	激怒；驱使			
annals	年鉴			
wither	枯萎			
garrulous	_嗦的			
viscous	粘稠的 粘的			
prerogative	特权			
luminary	n 杰出人物			
diocesan	主教管辖区的			
cement	连接粘合			
denouement	（小说的）结局			
caprice	一时冲动的决定；反复无常			
wanting	缺少的；未达到要求的			
infiltrate	秘密潜入			
designate	任命；命名			
ration	定量配给；按比例分配			
neophyte	新手			
persecute	迫害			
opaque	不透光的；晦涩的			
suppress	抑制；镇压 终止			
supine	懒散的；消极倦怠的			
perceptible	可察觉的			
imbroglio	纠纷；困境			
entice	诱使			
overwhelm	淹没；使难以承受			
sepulchral	丧葬的；阴沉的			
bootless	无用的			
embrace	乐于接受；包围			
gargantuan	巨大的			
attune	使协调			
analgesic	镇痛剂			
proficient	熟练的			
jape	嘲弄			
rile	惹怒			
concatenate	连结			
execrate	谴责			
vestigial	发育不全的、退化的			
plush	味道浓郁的；奢华的			
rumple	弄皱；弄乱			
boisterous	喧闹的			
precursor	先驱			
analogous	相似的，可比较的			
downpour	倾盆大雨			
clement	仁慈的；气候温和的			
sparse	稀疏的			
spiny	多刺的；棘手的麻烦的			
wiretap	偷听			
disjointed	机能失调的；散乱的不连贯的			
facilitate	使容易；促进			
counterproductive	相反效果的，事与愿违的			
cramped	狭窄的			
grieve	使痛苦；严重的；令人悲痛的			
hallucination	幻觉			
redundant	多余的			
ascendant	主宰的、有影响力的；上升的			
ethereal	轻巧精致的；天国的；精神上的			
advertise	做广告			
mirage	幻影海市蜃楼			
slant	角度看法；倾斜的；歪曲			
lenient	宽大仁慈的			
dehydrate	脱水；使失去活力			
eclectic	多元化的			
needy	贫困的			
molt	脱羽、皮			
exude	分泌流出			
recessive	隐性的；内向的			
intensify	加强			
judicious	明智的			
aspersion	诽谤			
probe	深入调查			
comely	漂亮的			
acute	敏锐的；急性的；程度深的			
myriad	无限的大量的			
imperative	命令的；迫切的；必要的			
staunch	忠诚的，坚定的			
estrange	使疏远			
maven	n 专家			
bigot	固执己见者			
embark	上船；开始从事			
emaciate	使变瘦；使虚弱；削弱			
therapeutic	治疗的			
tact	机敏；圆滑			
repartee	机灵的回答；打趣，善意的玩笑			
jocund	欢乐的			
aesthetics	美学			
constitute	任命；构成			
ripen	使成熟			
retouch	润饰，改进			
trite	陈腐的			
drudgery	苦工；单调无趣的工作			
gladiator	角斗士；参与打斗或辩论的人			
inflame	使加剧；点燃助燃			
bewitching	迷人的			
shrink	减少；退缩；犹豫			
engross	使全神贯注			
repertoire	全部剧目；详单			
commitment	致力；确信；承诺			
playful	爱开玩笑、打闹的			
taxing	繁重的；费力的			
denude	脱去			
overbearing	专横傲慢的；压倒一切的；支配的			
simpleton	笨蛋			
wary	小心的；机警的			
substitute	替代品；取代			
heckle	起哄，使难堪			
dilate	使膨胀；详细表述			
agonize	折磨；感到痛苦			
conciliate	安抚；调解			
sham	欺骗；虚假的；掩饰假装			
condone	宽恕			
studio	工作室；画室；摄影室			
miserly	吝啬的			
sweltering	酷热的			
disengage	分开			
forsake	彻底放弃			
commensurate	同样大小的；相称的			
impassive	冷漠的			
nettle	惹怒			
mangle	vt 损毁；弄砸			
murky	模糊的；晦涩的			
jaunty	轻快的			
pillar	柱子；精神、物质支柱			
confident	自信的			
fetid	恶臭的			
revive	恢复意识；再获新生			
unanimous	一致同意的			
reprobate	堕落者；堕落的；谴责；拒绝			
spectrum	光谱；范围，系列			
indoctrinate	教育			
singe	轻微烧焦			
solicitous	关心挂念的；迫切渴望的			
chauvinistic	盲目爱国的			
caustic	腐蚀的；刻薄的			
deft	灵巧的			
alloy	合金 混合物；掺杂			
husky	沙哑粗糙；高大威猛			
eclipse	使声望下降使黯然失色；下降衰退；超越			
polished	有教养的；擦亮的			
array	排列；摆放；装饰			
satirize	讽刺			
adumbrate	部分揭露；预示着			
grisly	令人反感的			
deliberate	深思熟虑的			
trickle	一滴滴地流			
cachet	同意；声望			
rapprochement	和睦 友好			
forebode	预兆			
murmur	小声说话；低声抱怨			
shrewd	精明的；强烈的			
unpretentious	低调的；坦诚的自然的			
waylay	伏击；埋伏			
outmoded	过时的 			
wrangle	纷争争端；争吵			
sturdy	强健的			
buoyant	有浮力的；快乐的			
lacerate	使非常痛苦			
immaculate	纯净的；完美的			
deprivation	匮乏			
profusion	丰富；挥霍			
maverick	n 特立独行的人；a 非常规的，标新立异的			
balk	阻碍；拒绝			
ballad	由简单诗节和叠句组成的民歌			
potentiate	加强激活			
labile	易变的			
tempestuous	突然的，剧烈的			
willful	固执的；故意的			
fateful	重大的；毁灭性的			
cede	放弃、割让			
soliloquy	独白			
belligerence	好斗 好战			
pointer	指针；忠告建议			
virtuoso	艺术鉴赏家 专家；技艺精湛的			
philatelist	集邮家			
sectarianism	宗派主义，顽固			
cynic	愤世嫉俗者			
serrated	锯齿状的			
forfeit	罚金			
slack	松弛的；疏忽大意的			
waddle	摇摇摆摆地走			
desecrate	亵渎			
misrepresent	误传篡改			
variegated	杂色的 斑驳的			
hie	匆匆忙忙			
serried	密集的			
banish	驱逐出境			
frosty	寒冷的；冷淡的			
calcify	使僵化			
quiescent	平静的			
mutter	低声抱怨			
arresting	吸引人的			
castigate	强烈反对指责			
puissance	权力			
rein	控制，抑制，限制			
subordinate	下级的；次要的；征服			
secluded	隐蔽的			
browbeat	恐吓			
suspend	暂停；悬挂			
despicable	可鄙的；不得体的			
contaminate	污染			
substantial	物质的；有重大意义的			
frequent	时常拜访；频率			
beleaguer	围攻；困扰			
blur	使模糊；使不易理解			
feral	野生的；动物性的			
milk	vt.榨取（财富、信息）			
repine	抱怨不满；渴望			
hangdog	伤心的			
abundant	大量的			
adventitious	后天的，非内在的			
conundrum	谜			
puny	微小的			
pulverize	研磨成粉；彻底摧毁			
pertinent	相关的			
disjunctive	分离的			
nonplus	使迷惑使困窘			
gawky	笨拙的			
fail-safe	万无一失的；保险措施			
evacuate	撤空；撤退			
pillory	当中嘲弄			
default	拖欠债务、不履行义务			
dodge	快速地躲闪			
upbraid	谴责			
discharge	解雇；释放；不承担责任			
propensity	癖好；倾向			
headlong	鲁莽的			
pithy	精炼的			
daunt	吓到			
dike	堤坝；水渠			
arduous	费力的			
subdue	征服；压制；减轻			
overture	前言；序曲			
debut	正式步入社会；初次登台			
ally	盟友；加入联盟			
diplomatic	机智的			
sinecure	美差			
infraction	违背			
lash	捆扎；撞击；击打			
sop	安慰物；贿赂；浸湿			
domicile	住所；为提供住所			
primp	精心打扮			
striate	加条纹			
nauseate	使厌恶使作呕			
tendentious	有偏见的			
hurricane	飓风；引起动荡之事			
travesty	拙劣的、嘲弄性的模仿			
commodious	宽敞的			
affection	爱			
nudge	用肘轻推以引起注意；说服某人做某事			
monologue	独白			
implicit	不言而喻的；无疑问的无保留的			
insensible	无知觉的；漠不关心的；没品位的			
euphonious 	悦耳的			
submerge	使淹没			
clarity	清晰			
ponderous	笨重的；沉闷无聊的			
addict	沉溺；上瘾的人			
wastrel	败家子			
curmudgeon	脾气怪的人爱抱怨的人			
console	安慰			
sly	狡猾的；隐秘的			
piebald	杂色的；混合的			
hermetic	深奥的			
masquerade	n 伪装；vi 伪装			
stigma	耻辱，污名			
roster	花名册、执勤表			
obfuscate	使困惑使模糊			
illumination	照明；启发；阐明			
baroque	华丽装饰的；程度上过分的			
dolt	笨蛋			
dwindle	逐渐减少			
equivocate	模棱两可地说（以欺骗或逃避承诺）			
nascent	新生的			
surveillance	监控			
stomach	容忍			
				
				
				
				
				
				
				
				
				
				