sequela	结果			
stringent	绷紧的；严格的			
quash	镇压			
inexorable	无法劝阻的			
eminence	杰出			
squeamish	恶心的、晕船的			
concrete	实体的实在的；明确的事实性的			
goggle	凝视			
mercurial	a. （情绪）善变的			
retrench	削减开支			
pilfer	偷窃			
leer	一瞥			
equilibrium	平衡；平静			
don	穿上			
tenacious	顽固的不屈不挠的；黏着的			
discern	识别			
lustrous	a 有光泽的			
aggressive	好斗的；强有力的			
distort	扭曲			
concede	承认；停止抵抗			
avowal	承认 公开宣布			
reluctant	不情愿的			
pore	仔细研究			
committed	忠诚的			
courteous	谦恭有礼的			
sapient	聪明的			
metamorphose	vt. 使变形			
paradigm	典范			
ostensible	表面上的，佯装的			
insulate	使绝缘使隔离			
gild	修改润色			
fraudulent	欺诈的			
maneuver	巧妙地操纵			
vault	跳跃；一跃而至			
antediluvian	非常古老的；过时的；保守的人			
fathom	彻底理解；测量			
caveat	警告			
contrived	不自然的，刻意的			
skeptic	怀疑者			
provident	节俭的；有远见的			
endorse	公开支持			
vaporize	使蒸发；彻底消灭			
jejune	无趣沉闷的；幼稚的			
saccharine	有甜味的；做作的矫情的			
hasty	轻率的			
delegate	代表；移交			
notch	刻痕；通过努力获得			
implode	内爆			
sober	严肃的；节制的；有理有据的			
offish	冷淡的			
suture	缝合			
vaccinate	预防接种疫苗			
tinker	乱修乱调整			
nullification	废除			
recuperate	恢复；康复			
commiserate	表示怜悯同情			
accumulate	逐渐增长			
peer	同等地位的人；好奇地凝视			
transient	短暂的			
escort	护卫队；同行护送			
adamant	固执的			
minutiae	次要的细节、小事			
valid	逻辑上正确的			
incandescent	明亮灿烂的；热情饱满的			
circumvent	躲避绕行			
worldly	世俗的；老练的			
nicety	准确；细微差别			
ruminate	沉思			
foment	煽动			
retribution	报偿、报应 			
integrity	正直；完整			
viable	可行的			
circuitous	不直接的；冗长的			
kindle	点燃			
egalitarian	平等主义的			
havoc	大混乱；大面积破坏			
startle	使大吃一惊			
stultify	使无效			
snobbish	自大的			
chagrin	沮丧懊恼			
debilitate	使衰弱			
allure	引诱			
transcend	超越			
felony	重罪			
volition	意志、抉择			
expiate	赎罪纠正			
obloquy	谩骂；恶名耻辱			
bogus	伪造的；虚伪做作的			
drench	湿透			
incantation	咒语			
dulcet	悦耳的			
abash	使尴尬			
malaise	n 不舒服			
pungent	辛辣的，讽刺的			
haphazard	无秩序的			
sensitive	敏感的			
fallacious	荒谬的；欺骗性的			
elicit	唤起			
meteoric	a. 流星般迅速而短暂的			
amalgamate	合并			
timely	及时的；恰到好处的			
unremitting	连续不断的			
spate	突发的洪水；大量			
brake	刹车			
ill-bred	没礼貌的			
discretion	谨慎慎重；自制节制			
decipher	破译；理解			
religion	信仰；虔诚忠诚			
arrhythmic	不规律的			
crest	浪尖；山顶			
stint	吝惜			
parrot	机械地模仿、复制			
summit	顶点			
boon	恩惠；喜欢集体行动的			
torrid	酷热的；热情的，感情深厚的			
impotent	无力的；无生育能力的			
apostasy	放弃宗教信仰；变节			
mediocre	a 平庸的；质量中等偏下的			
mimic	a. 仿真的；vt. 模仿；vt. 滑稽地模仿（以取笑）			
catastrophe	大灾难			
lurch	vi 蹒跚			
quotidian	平凡的；每日的			
ethics	道德规范			
clot	密集的一群；堵塞；凝结			
deter	威慑			
full-bodied	味道浓烈的；重要的			
groggy	虚弱的 走路不稳的；头脑不清醒的			
renege	放弃			
fiasco	大失败			
reprieve	缓刑免罪；维持……运行			
elucidate	阐明			
acme	顶点			
circumspect	谨慎的			
spectator	观众			
accord	授予；相一致；一致			
laborious	勤奋的；费力的			
decode	解码；理解			
incursion	入侵			
sartorial	裁缝匠的			
pry	刺探			
gamble	赌博；冒险			
burgeon	迅速长大			
torpor	缺乏兴趣；迟钝懒散			
breach	破坏；违背			
gibe	嘲弄			
scorn	蔑视			
careworn	忧心忡忡的			
principal	主要的			
palpitation	有节奏的舒张收缩			
robust	精力充沛的；强壮健康的			
underdog	受害者，输家			
earshot	听力所及的范围			
ticklish	易怒的；棘手的对技巧要求高的			
psychology	心理学；心理战术			
meretricious	艳俗的			
porous	多孔可渗透的			
pellucid	透明的；清晰易懂的			
tacit	暗示			
persiflage	打趣			
esteem	尊重			
quaff	大口地喝			
collaborate	合作			
unavailing	徒劳的			
bromide	陈词滥调			
momentous	极重要的			
impenitent	不悔悟的			
licentious	a.放荡的，性欲强的			
enigma	迷			
specious	似是而非的，欺骗性的			
sumptuous	豪华的			
lurk	vi 潜伏			
embed	嵌入			
elbow	肘关节			
sinuous	蜿蜒曲折的			
dirge	挽歌			
rider	骑马的人；附加条款			
abstruse	难以理解的			
antiquated	古老过时的			
agenda	议程			
pernicious	有害的；致命的			
patrician	贵族；贵族的			
sulk	生气恼怒			
integral	构成整体所必需的			
plagiarize	剽窃			
amenity	舒适、人性化；和谐			
parch	烤干			
morose	忧郁的			
grimace	因痛苦而面部扭曲			
jeopardy	危险			
remiss	疏忽的			
enamel	涂亮漆；用亮丽的表面装饰			
relevant	有关系的；重要的			
resuscitate	使苏醒			
bluster	大声吹嘘；恐吓；喧闹的状态			
consummate	专业的有造诣的；完美的；最高档次的			
infuriate	激怒			
slew	大量			
confluence	汇合			
embolden	鼓励			
oblivious	不知道的不知情的；健忘的			
submissive	服从的；恭顺的			
paradise	天堂极乐世界；狂喜			
prerequisite	先决条件、前提			
complacent	自满的；无所谓不关心的			
heresy	异教			
gloomy	忧郁的；暗淡无光的			
pedagogical	教学的；教师的			
elephantine	巨大的，笨拙的			
harbinger	预言者			
husk	外壳；剥去			
ossify	僵化；骨化			
dreary	单调乏味的；令人不悦的			
solemnity	严肃			
invective	侮辱性的			
secrete	隐藏；分泌			
recidivate	重新犯罪，回到原来的习惯			
expire	断气死亡；到期			
coltish	不守纪律的；爱开玩笑的			
perforate	打孔			
trifle	不重要的事；玩弄			
hobble	蹒跚而行；阻碍			
fluster	使慌乱			
antipathy	反感厌恶；令人反感的事物			
friable	易碎的			
lax	松弛的 不严格的；漫不经心的			
mundane	尘世的；平凡的			
vague	表达不清楚的、轮廓不清晰的			
donor	捐赠人			
conceal	隐藏			
verve	活力热情			
largesse	慷慨；捐赠物			
reproach	责备；耻辱			
discompose	使不安使混乱			
practitioner	专业人士			
rabble	混乱的人群；暴民；下层民众			
malevolent	恶意的			
residual	剩余的			
habitable	可居住的			
preoccupation	非常关心			
affliction	痛苦折磨			
atrophy	萎缩衰退			
forebear	祖先			
emulate	效仿并努力超越			
skimp	吝啬；节省花费；缺乏的不足的			
plangent	轰鸣的；哀伤的			
sate	使满足			
pandemonium	"喧嚣,骚动"			
disabuse	打消错误念头，纠正			
ruse	诡计			
politic	精明能干的；明智的			
prodigal	败家子；挥霍的			
nadir	最低点			
solvent	有偿付能力的；溶剂			
barb	严厉的批评			
seduce	劝说			
rite	惯例、仪式			
berate	严厉指责			
throng	大量聚集			
jubilant	喜悦的			
mischievous	调皮的；有害的			
furor	喧闹;激动			
embarrass	使尴尬；阻碍			
callous	冷漠的；无情			
circumscribe	限制；包围			
finicky	过分讲究的			
simile	明喻			
half-baked	不明智的			
testimony	证据；声明			
fleeting	稍纵即逝的			
prophetic	预言的；预示的			
revenge	报复，复仇			
enunciate	清晰发言；公开宣布			
timeworn	陈腐的			
monotone	声音单调的；清一色的无聊的			
figurative	比喻的			
secular	世俗的			
inferno	大火；地狱			
reconstitute	重建，加水使复原			
rift	离间；使开裂			
chromatic	彩色的			
repudiate	否认；拒绝接受			
dilapidate	使荒废			
distain	贬损；弄脏			
slake	使满足			
squabble	小争吵			
mediate	vt 调解、调停			
applause	鼓掌；认可			
knack	诀窍			
cultivate	培养；促进成长			
deflect	使倾斜 使转向			
beneficent	仁慈的；有益的			
inherent	本质的			
subjugate	征服镇压；剥夺自由			
chaff	开玩笑			
understated	朴素的；不惹眼的			
demagogue	蛊惑民心的政客			
unkempt	凌乱的 无序的			
covert	隐藏的；隐秘掩护所			
fallible	可能出错的			
prototype	原型			
