seminal	有发展性的；创新的			
importune	恳求 迫切请求			
blunt	使变钝；减弱；直率的			
blasé	厌倦享乐的			
proclaim	宣告			
vignette	简介、短文			
pertain	适合；属于；有关联			
mosaic	镶嵌图案；综合物，马赛克般的东西			
taciturn	沉默寡言的			
fastidious	挑剔的 			
loll	vi.懒洋洋地行动；vi.偷懒			
fetter	束缚；枷锁限制			
soak	浸泡			
edifice	大厦；基础			
requite	酬谢；报答；报仇			
latitude	自由			
abreast	并排的；熟知的			
replenish	补充			
debase	贬低			
inaugurate	使就职；开始			
disaffected	不满的、叛逆的			
exploit	英雄行为；最大程度利用			
premeditate	预先考虑			
laconic	简洁的以至于显得粗鲁的			
conserve	保存			
torrential	急流的			
insensitive	缺乏机智圆滑的；麻木的			
exacerbate	使恶化			
colossal	巨大的			
accessory	辅助的；帮凶			
malicious	a 恶意的			
simulate	模仿；模拟			
static	静态的；不易改变的			
inquisitive	过分好奇的			
stigmatize	使蒙受污名			
intrinsic	固有的内在的			
blandishment	以甜言蜜语哄骗			
abiding	永久的			
rend	撕裂			
obviate	排除			
scour	用力擦洗；搜查			
scrutinize	仔细检查			
excoriate	严厉批评			
boggle	因为怀疑而犹豫；笨拙地做			
craven	胆小得令人鄙视的			
sluggard	懒鬼			
raffle	垃圾废物			
avid	急切渴望的；贪财的			
accede	赞成；就职			
influx	涌入			
cohesive	有粘性的；有凝聚力的			
cosset	宠爱			
evasive	含糊其辞的；难以发现捕捉的分离的			
earnest	严肃认真的			
correlate	使……相关联			
equivalent	等价的			
frustrate	挫败；使沮丧			
claim	要求；对于�的权利			
ingenuity	独创性			
confine	禁闭；限制			
proofread	校对			
infelicitous	不幸的；不恰当的			
dilute	稀释；削弱			
malcontent	n 不满分子；a 不满的			
idiosyncrasy	独特而奇怪的习惯			
construct	建造			
conflate	混合			
scorch	烘干，炙烤			
predecessor	前辈			
deploy	展开；调度部署			
crook	使弯曲			
distill	用蒸馏提纯；渗出滴下			
wanderlust	旅行癖			
gaudy	俗丽的			
hypocritical	伪善的			
fad	流行，时尚			
sparing	节俭的；不足的			
vaunt	吹嘘			
blatant	喧哗的；非常明显的			
fitful	无规律的			
nourish	养育；培养促进			
efface	擦掉			
odium	憎恶			
explicate	解释说明			
inanimate	无生命的			
crux	中心			
piddling	微不足道的			
conjure	恳求；想起			
dilettante	业余爱好者缺乏专业技术的			
vulgar	粗俗的；口头的非正式的			
erudite	博学的			
reproof	批评反对			
effervesce	热情洋溢；冒泡			
sycophant	马屁精			
trumpet	大声说出或宣告			
scoff	嘲笑；狼吞虎咽			
vicissitude	自然变化、变迁兴衰			
autonomy	政治上的独立；精神上的独立、自我主导的自由			
topsy-turvy	混乱不整洁的			
opine	表达观点；认为			
elliptical	含糊不清的；椭圆的			
diffident	不自信的；沉默的内向的			
thwart	阻挠			
agility	敏捷			
fallow	休耕的；闲置的			
purloin	偷窃			
extinct	灭绝的			
prodigious	巨大的；惊人的了不起的			
archetype	典范；鼻祖；原型			
acrid	辛辣的；刻薄的			
fulminate	大声斥责			
acclimate 	使适应			
bolster	支持；鼓励			
sonnet	十四行诗			
weather	经受住			
philistine	市侩（注重物质而鄙视智慧或艺术的人）			
surrogate	替代品			
demoralize	使士气低落			
retaliate	报复			
laudatory	表示赞扬的			
temporize	行动躲躲闪闪以争取时间、躲避争论等			
menial	仆人；卑贱的			
haven	安全的地方			
occult	隐藏的；难以理解的；使隐藏或神秘			
copious	丰富的			
sterile	贫瘠的；无菌的			
humility	谦卑			
foolproof	十分简单以至于不会失败的			
sabotage	妨害；破坏；阻止			
proliferate	快速繁殖；激增			
supposition	猜想			
sand	磨光；沙			
satire	讽刺诗，讽刺文学			
carnal	肉体的；世俗的			
sequel	结果			
inclement	恶劣的；无情的			
irate	极其愤怒的			
grin	咧嘴笑			
insentient	无感觉的；一知半解的			
scurvy	下流的			
ratiocination	推理			
immature	未成熟的			
conservatory	艺术学院；温室			
abdicate	正式放弃			
euphemism	委婉语			
mockery	鄙视；用以嘲笑的模仿			
preposterous	荒谬的			
forge	伪造；锻造铸造			
supplant	排挤；篡夺位置			
lugubrious	a （故作夸张的）悲哀的			
wax	增大；月亮渐满；上光			
lachrymose	催人泪下的			
genial	和蔼可亲的；友好的；温暖的			
derelict	玩忽职守的；被社会遗弃的人			
elaborate	详细的；详细说明			
somber	忧郁的；昏暗的			
hubris	狂妄自大			
advert	引起注意、提到			
medley	a 大杂烩、混合物			
dank	阴湿的			
ardor	狂热			
stoke	添加燃料；促进			
vapid	无趣的			
moratorium	延期、暂缓施行			
petulant	易怒的			
pandemic	大规模流行的			
convenience	便利			
deride	嘲弄			
refractory	倔强的，不顺从的			
nugatory	无关紧要的			
parody	模仿以嘲弄			
lopsided	a.歪的；a.d不协调的			
sedate	镇静的			
perspicuity	清晰明了			
segment	分割；部分			
epigram	警句、机智的短诗			
sanctuary	避难所			
vex	使烦恼			
animate	活的；有活力的；使有活力			
fertilize	使肥沃			
procure	获得			
founder	完败；沉没			
callow	不成熟的			
rife	丰富的、普遍的			
disgruntle	使发怒			
stalwart	健壮的；无所畏惧的；坚定地			
assail	抨击；攻击			
depreciate	贬值；轻视			
sidestep	不遵守			
ken	视野范围；知道了解			
arrogance	傲慢			
abominate	憎恶			
jog	慢跑；唤起			
orient	确定方向			
circumlocution	绕圈子的话；冗长			 
nerve	鼓起勇气；意志勇气			
supercilious	高傲的			
quell	压制；平息			
noisome	有毒的；恶臭的；非常讨厌的			
liken	v.把……比作			
waft	飘荡			
sedentary	固定不动的			
sensation	感觉；轰动事件			
extrapolate	逻辑推断			
annoy	不断烦扰			
scathing	尖酸刻薄的			
precarious	危险不稳定的；可疑的			
contemplate	沉思			
camouflage	伪装；隐瞒			
fickle	易变的；不忠诚的			
mania	n 热衷、狂热			
vicarious	代理的、取代的			
errant	误入歧途的；居无定所的			
acerbic	尖酸的			
sin	罪恶的事			
flaccid	松弛的			
boycott	联合抵制			
transparent	透明的；清晰易懂的；坦率的			
alibi	不在场证明；借口托辞			
ensue	紧随其后			
agog	极度感兴趣的			
airtight	无懈可击的；不透气的			
padding	废话、夸张			
alienate	疏远；转移、变卖			
humiliate	羞辱			
plight	困境			
varnish	上清漆；粉饰			
snare	捕捉；无法逃脱的困境			
fidelity	忠诚			
migratory	a.迁移的			
protean	善变的；多才多艺的			
phlegmatic	冷静的，冷漠的			
urbane	彬彬有礼的			
cliché	陈词滥调的			
perimeter	周长，边界			
fantasy	幻想			
cameo	栩栩如生地描绘或刻画；客串			
ominous	凶兆的			
supple	易弯曲的，柔软的			
taint	使污损			
appall	使惊恐			
inducement	动机；劝说			
aggrandize	增加；提高			
insouciant	不在乎的不纠结的			
plodding	走路沉重缓慢的			
disavow	拒绝承认			
prowess	英勇			
ubiquitous	无所不在的			
trudge	吃力而笨拙地走			
instigate	煽动			
disinterested	公正的；不感兴趣的			
jot	简要记录			
exorcise	除去			
equable	温和的			
specific	特有的；明确的			
nocturnal	夜间的；夜间活动的			
teeming	大量的			
crease	折痕			
frail	虚弱的；意志薄弱的；渺茫的			
categorical	绝对的，没有例外的			
sound	稳固的；健康强壮的；逻辑严谨的			
visionary	空想的；幻觉的；有远见的			
baffle	挫败阻挠；使疑惑			
deplete	耗尽			
trivial	微不足道的			
prescription	处方；规定			
paramount	最重要的			
inadvertent	偶然发生的；不留意的			
delirium	精神错乱；发狂			
fragile	易碎的；脆弱的			
patriot	爱国者			
dogged	坚决的；固执任性的			
carouse	畅饮			
bacteria	细菌			
comity	友好和谐			
renounce	声明放弃			
hamstring	使无效			
elastic	有弹性的；能恢复的			
propitious	吉祥的			
plunge	突然下降；插入刺入			
hard-bitten	顽强的			
tame	被驯化的；无聊乏味的；抑制控制			
venom	毒液；恶意			
relentless	残酷无情的；固执不妥协的			
pulchritude	美丽			
smarmy	虚情假意的			
astounding	令人吃惊的			
apprise	通知			
tyrant	暴君			
embroider	用刺绣装饰；伴有夸张的详细说明			
obsess	迷住；使困扰			
stymie	阻碍			
apocryphal	假的			
jitters	紧张不安			
desultory	散漫的无计划无目的的；令人失望的			
stratagem	谋略			
ad-lib	即兴的			
gull	欺骗			
eclat	辉煌成就			
infamous	声名狼藉的			
